species,vcm_count,non_vcm_count,obs_count,fisher_p,chi2_p
Abagrotis duanca,0,1,1,1.0,1.0
Abagrotis mirabilis,1,0,1,0.14476460320460613,0.3126936942061339
Abagrotis variata,0,1,1,1.0,1.0
Abies concolor,72,806,878,1.6201478349139666e-08,1.5304760739415647e-07
Abies magnifica,3,390,393,1.4936688440697926e-22,1.830614745825674e-14
Abronia alpina,0,6,6,0.6025804396089913,0.6688993551184468
Abronia nana,1,2,3,0.3744588472376553,0.9141432822130974
Abronia turbinata,0,10,10,0.3757244358299004,0.39438447212016514
Abutilon theophrasti,3,0,3,0.0030335293929702875,0.000700171082788584
Acalymma trivittatum,0,1,1,1.0,1.0
Acanthocinus princeps,1,2,3,0.3744588472376553,0.9141432822130974
Acanthus mollis,1,0,1,0.14476460320460613,0.3126936942061339
Acarospora fuscata,0,1,1,1.0,1.0
Accipiter cooperii,4,50,54,0.17509244908717747,0.19944547479472113
Accipiter gentilis,2,49,51,0.0275275077506787,0.05195651041345731
Accipiter striatus,1,20,21,0.3485544901265487,0.3394968187912247
Acer campestre,0,1,1,1.0,1.0
Acer circinatum,3,8,11,0.2054644031680506,0.4367258119699784
Acer glabrum,1,96,97,7.971830222432095e-06,0.00029450152092648486
Acer macrophyllum,162,321,483,5.62748758270939e-26,1.9772441402377132e-32
Acer negundo,4,0,4,0.00043910829886184923,3.314336839661014e-05
Acer platanoides,3,0,3,0.0030335293929702875,0.000700171082788584
Acer saccharinum,1,2,3,0.3744588472376553,0.9141432822130974
Aceria dispar,0,2,2,1.0,1.0
Aceria erinea,0,1,1,1.0,1.0
Aceria genistae,9,1,10,2.4259786172080083e-07,2.3235216610518305e-10
Acerra normalis,0,12,12,0.2360424886052977,0.31009055076592434
Achillea filipendulina,1,0,1,0.14476460320460613,0.3126936942061339
Achillea millefolium,83,695,778,0.0021493241984642695,0.002943037294301841
Achyrachaena mollis,1,0,1,0.14476460320460613,0.3126936942061339
Acilius abbreviatus,0,7,7,0.6034645370398923,0.5813304975648097
Aciurina bigeloviae,2,1,3,0.056801432979852025,0.0803492820202322
Acleris maximana,0,1,1,1.0,1.0
Acmaeodera connexa,3,14,17,0.7270000471496869,0.9785517440514542
Acmaeodera hepburnii,2,0,2,0.0209561639230412,0.01499159650771353
Acmaeodera labyrinthica,1,1,2,0.2685730424867646,0.6723203844978234
Acmaeodera mariposa,0,2,2,1.0,1.0
Acmispon americanus,9,54,63,1.0,1.0
Acmispon argophyllus,1,1,2,0.2685730424867646,0.6723203844978234
Acmispon brachycarpus,2,3,5,0.15522343689242213,0.32387652224382535
Acmispon decumbens,5,35,40,1.0,0.8960992025112787
Acmispon glaber,1,0,1,0.14476460320460613,0.3126936942061339
Acmispon grandiflorus,3,8,11,0.2054644031680506,0.4367258119699784
Acmispon parviflorus,3,5,8,0.09660076546782431,0.17754400284199642
Acmispon procumbens,1,0,1,0.14476460320460613,0.3126936942061339
Acmispon strigosus,0,2,2,1.0,1.0
Acolium inquinans,0,2,2,1.0,1.0
Aconitum columbianum,10,464,474,3.4459814064081677e-20,3.059589787286659e-14
Acossus populi,0,10,10,0.3757244358299004,0.39438447212016514
Acrolophus laticapitana,0,2,2,1.0,1.0
Acroncosa albiflavella,0,2,2,1.0,1.0
Acronicta cyanescens,0,1,1,1.0,1.0
Acronicta funeralis,1,0,1,0.14476460320460613,0.3126936942061339
Acronicta grisea,0,1,1,1.0,1.0
Acronicta impressa,0,4,4,1.0,0.9105509465652237
Acronicta insita,0,6,6,0.6025804396089913,0.6688993551184468
Acronicta lupini,0,3,3,1.0,1.0
Acronicta mansueta,0,1,1,1.0,1.0
Acronicta marmorata,1,2,3,0.3744588472376553,0.9141432822130974
Acronicta perdita,1,6,7,1.0,1.0
Acronicta spinea,0,3,3,1.0,1.0
Acronicta vulpina,0,1,1,1.0,1.0
Actaea rubra,5,205,210,5.410858261474294e-09,1.0288792758632603e-06
Acteniceromorphus volitans,0,1,1,1.0,1.0
Actinemys marmorata,11,16,27,0.0007982742016077558,0.0003117217807645189
Actitis macularius,0,60,60,0.00014378007469898363,0.002665672747563187
Aculus tetanothrix,1,3,4,0.4650164385481151,1.0
Adaleres ovipennis,2,0,2,0.0209561639230412,0.01499159650771353
Adalia bipunctata,1,6,7,1.0,1.0
Adeia whitneyi,0,7,7,0.6034645370398923,0.5813304975648097
Adejeania vexatrix,0,3,3,1.0,1.0
Adela eldorada,1,4,5,0.5424646889787644,1.0
Adela flammeusella,3,0,3,0.0030335293929702875,0.000700171082788584
Adela septentrionella,0,1,1,1.0,1.0
Adela trigrapha,2,1,3,0.056801432979852025,0.0803492820202322
Adelinia grande,153,62,215,1.3681260548431312e-78,1.6555304753375774e-122
Adenocaulon bicolor,35,313,348,0.017889734779506325,0.023290103770473157
Adenostoma fasciculatum,8,1,9,1.5113716238966603e-06,4.3344519411722725e-09
Adiantum aleuticum,5,52,57,0.26220095609850014,0.30023113948569585
Adiantum capillus-veneris,1,2,3,0.3744588472376553,0.9141432822130974
Adiantum jordanii,73,0,73,4.9454508129927385e-62,2.503150945142367e-94
Aechmophorus clarkii,0,1,1,1.0,1.0
Aechmophorus occidentalis,0,7,7,0.6034645370398923,0.5813304975648097
Aedes fitchii,0,1,1,1.0,1.0
Aedes melanimon,0,1,1,1.0,1.0
Aedes sierrensis,0,2,2,1.0,1.0
Aedes ventrovittis,0,1,1,1.0,1.0
Aegilops triuncialis,6,2,8,0.00019772693610894856,1.2839299064071593e-05
Aegolius acadicus,3,10,13,0.41916983303031286,0.626122924488651
Aeorestes cinereus,0,1,1,1.0,1.0
Aeronautes saxatalis,4,4,8,0.01886984470142184,0.01861366248431812
Aesculus californica,138,20,158,5.606209814928689e-93,3.271757480908027e-148
Aeshna interrupta,0,32,32,0.010653294055563268,0.03786379733207584
Aeshna palmata,0,19,19,0.09746384240092232,0.14226189947649115
Aeshna umbrosa,1,11,12,1.0,0.845714857147599
Aeshna walkeri,2,5,7,0.2688137426846044,0.6011437582684053
Aethaloida packardaria,2,2,4,0.10278607328810296,0.1906437976216683
Aethes smeathmanniana,0,3,3,1.0,1.0
Agaricus arorae,1,0,1,0.14476460320460613,0.3126936942061339
Agaricus augustus,0,1,1,1.0,1.0
Agaricus buckmacadooi,1,0,1,0.14476460320460613,0.3126936942061339
Agaricus deardorffensis,1,0,1,0.14476460320460613,0.3126936942061339
Agaricus diminutivus,2,0,2,0.0209561639230412,0.01499159650771353
Agaricus hondensis,1,2,3,0.3744588472376553,0.9141432822130974
Agaricus kerriganii,1,0,1,0.14476460320460613,0.3126936942061339
Agaricus moronii,1,26,27,0.1664908585838914,0.1876753474441988
Agaricus porphyrocephalus,0,1,1,1.0,1.0
Agaricus subrutilescens,1,0,1,0.14476460320460613,0.3126936942061339
Agaricus xanthodermus,0,1,1,1.0,1.0
Agastache urticifolia,3,209,212,5.762846670135529e-11,1.0957152088340801e-07
Agave americana,1,0,1,0.14476460320460613,0.3126936942061339
Agelaius phoeniceus,12,79,91,0.8814018520345841,0.8409163995628663
Agelaius tricolor,1,1,2,0.2685730424867646,0.6723203844978234
Ageratina occidentalis,2,117,119,2.951140435740504e-06,0.00012407515940246182
Aglais milberti,0,24,24,0.03967208129449859,0.08442030606095953
Aglaothorax ovatus,0,2,2,1.0,1.0
Aglossa cacamica,0,1,1,1.0,1.0
Agnorhiza bolanderi,6,0,6,9.199825086801498e-06,7.715317253706965e-08
Agnorhiza elata,15,1,16,3.5430646499797675e-12,4.845369092180349e-18
Agnorhiza invenusta,5,6,11,0.013693210356916412,0.012717642011991449
Agnorhiza ovata,1,2,3,0.3744588472376553,0.9141432822130974
Agnorhiza reticulata,1,0,1,0.14476460320460613,0.3126936942061339
Agonum limbatum,0,1,1,1.0,1.0
Agoseris aurantiaca,0,20,20,0.10203106758234803,0.12794167189413608
Agoseris glauca,0,4,4,1.0,0.9105509465652237
Agoseris grandiflora,0,2,2,1.0,1.0
Agoseris heterophylla,0,1,1,1.0,1.0
Agoseris monticola,0,1,1,1.0,1.0
Agoseris parviflora,0,2,2,1.0,1.0
Agoseris retrorsa,6,37,43,1.0,1.0
Agriades glandon,0,4,4,1.0,0.9105509465652237
Agriades podarce,6,121,127,0.0008770255955288578,0.0027154186733293235
Agrilus politus,0,1,1,1.0,1.0
Agrimonia gryposepala,1,0,1,0.14476460320460613,0.3126936942061339
Agriotes thevenetii,0,1,1,1.0,1.0
Agrobacterium radiobacter,1,0,1,0.14476460320460613,0.3126936942061339
Agrocybe pediades,3,9,12,0.3994183286503844,0.5314104390489738
Agrocybe praecox,0,2,2,1.0,1.0
Agrocybe putaminum,2,0,2,0.0209561639230412,0.01499159650771353
Agropyron cristatum,0,5,5,1.0,0.7760428250025136
Agrostis capillaris,1,1,2,0.2685730424867646,0.6723203844978234
Agrostis exarata,1,1,2,0.2685730424867646,0.6723203844978234
Agrostis pallens,0,1,1,1.0,1.0
Agrostis stolonifera,0,1,1,1.0,1.0
Agrostis variabilis,0,2,2,1.0,1.0
Agrotis ipsilon,1,3,4,0.4650164385481151,1.0
Agulla adnixa,0,1,1,1.0,1.0
Agulla bicolor,1,0,1,0.14476460320460613,0.3126936942061339
Agymnastus venerabilis,0,4,4,1.0,0.9105509465652237
Ahtiana pallidula,0,1,1,1.0,1.0
Ailanthus altissima,22,3,25,5.003936727007606e-16,2.8651594089190317e-24
Aimophila ruficeps,8,1,9,1.5113716238966603e-06,4.3344519411722725e-09
Aira caryophyllea,1,0,1,0.14476460320460613,0.3126936942061339
Aix sponsa,2,35,37,0.1582152487866142,0.1819901968120017
Ajuga reptans,0,1,1,1.0,1.0
Alaus melanops,15,68,83,0.34862855332425435,0.4382109371405539
Albatrellopsis ellisii,0,1,1,1.0,1.0
Albizia julibrissin,1,1,2,0.2685730424867646,0.6723203844978234
Albuna pyramidalis,0,4,4,1.0,0.9105509465652237
Alcea rosea,1,0,1,0.14476460320460613,0.3126936942061339
Alectoria sarmentosa,0,1,1,1.0,1.0
Alectoris chukar,0,2,2,1.0,1.0
Aleuria aurantia,2,11,13,1.0,1.0
Aleurodiscus grantii,0,1,1,1.0,1.0
Aleuroplatus coronata,1,0,1,0.14476460320460613,0.3126936942061339
Aliatypus janus,1,0,1,0.14476460320460613,0.3126936942061339
Aliciella latifolia,0,1,1,1.0,1.0
Aliciella triodon,0,2,2,1.0,1.0
Alisma triviale,0,1,1,1.0,1.0
Allacrotelsa spinulata,0,1,1,1.0,1.0
Allium abramsii,5,11,16,0.06970472631189019,0.12074944300889731
Allium amplectens,5,7,12,0.02071365806663339,0.023406060107138856
Allium anceps,0,1,1,1.0,1.0
Allium atrorubens,6,49,55,0.5669473363656072,0.5752329355607797
Allium bisceptrum,5,38,43,0.82770737874339,0.7533704088149669
Allium burlewii,0,4,4,1.0,0.9105509465652237
Allium campanulatum,16,407,423,6.971501654781964e-13,6.080960018536676e-10
Allium cratericola,1,1,2,0.2685730424867646,0.6723203844978234
Allium fimbriatum,2,0,2,0.0209561639230412,0.01499159650771353
Allium hyalinum,0,2,2,1.0,1.0
Allium jepsonii,2,0,2,0.0209561639230412,0.01499159650771353
Allium lemmonii,0,7,7,0.6034645370398923,0.5813304975648097
Allium membranaceum,8,5,13,0.00012493599837919194,9.489826548441195e-06
Allium obtusum,3,78,81,0.0037906346905903056,0.009373829425073995
Allium parvum,0,3,3,1.0,1.0
Allium peninsulare,4,1,5,0.0019413025415773043,0.00041787713651955216
Allium platycaule,2,20,22,0.7605811964984595,0.6781643221724958
Allium sanbornii,2,6,8,0.3262180684327187,0.7311980927864552
Allium shevockii,2,2,4,0.10278607328810296,0.1906437976216683
Allium tribracteatum,0,5,5,1.0,0.7760428250025136
Allium triquetrum,1,0,1,0.14476460320460613,0.3126936942061339
Allium validum,6,389,395,3.673471196410065e-19,4.027379185289784e-13
Allium yosemitense,1,0,1,0.14476460320460613,0.3126936942061339
Allocalicium adaequatum,0,1,1,1.0,1.0
Allograpta obliqua,1,1,2,0.2685730424867646,0.6723203844978234
Allokermes essigi,1,0,1,0.14476460320460613,0.3126936942061339
Allophyllum capillare,0,4,4,1.0,0.9105509465652237
Allophyllum divaricatum,2,6,8,0.3262180684327187,0.7311980927864552
Allophyllum gilioides,2,25,27,0.41609323465062054,0.4410007741051609
Allophyllum integrifolium,0,26,26,0.025555133894118995,0.0688671495635685
Allotropa virgata,3,113,116,3.088615666744966e-05,0.0004504224541041338
Alnus incana,2,58,60,0.009286323014237026,0.023210232576616523
Alnus rhombifolia,12,18,30,0.0005669422791192447,0.00020406961404867785
Alopecosa kochi,5,11,16,0.06970472631189019,0.12074944300889731
Alopecurus pratensis,0,2,2,1.0,1.0
Alpova trappei,0,1,1,1.0,1.0
Altica ambiens,0,4,4,1.0,0.9105509465652237
Alucita montana,0,8,8,0.6124215574698968,0.5084255632839996
Alypia langtonii,0,24,24,0.03967208129449859,0.08442030606095953
Alypia maccullochii,0,25,25,0.04095412181173697,0.07622457957144455
Alypia ridingsii,0,10,10,0.3757244358299004,0.39438447212016514
Alyssum turkestanicum,0,1,1,1.0,1.0
Amanita alpinicola,2,5,7,0.2688137426846044,0.6011437582684053
Amanita aprica,1,43,44,0.01643618076915838,0.036921759051915914
Amanita augusta,4,0,4,0.00043910829886184923,3.314336839661014e-05
Amanita calyptroderma,33,12,45,9.251221042273385e-19,3.4061361649876233e-28
Amanita constricta,1,1,2,0.2685730424867646,0.6723203844978234
Amanita magniverrucata,0,1,1,1.0,1.0
Amanita muscaria,4,169,173,1.0714510556217861e-07,8.952838432393834e-06
Amanita novinupta,3,3,6,0.0431068667335647,0.05837521372070738
Amanita ocreata,1,1,2,0.2685730424867646,0.6723203844978234
Amanita pachycolea,5,2,7,0.0010327341762908842,0.00018014051424031924
Amanita pantherina,2,1,3,0.056801432979852025,0.0803492820202322
Amanita pantherinoides,2,13,15,1.0,1.0
Amanita phalloides,2,0,2,0.0209561639230412,0.01499159650771353
Amanita silvicola,1,0,1,0.14476460320460613,0.3126936942061339
Amanita smithiana,2,0,2,0.0209561639230412,0.01499159650771353
Amanita velosa,5,3,8,0.0024244129099057063,0.0007850786162003298
Amanita vernicoccora,33,60,93,3.7923102745806547e-07,2.005237157924847e-08
Amaranthus albus,1,1,2,0.2685730424867646,0.6723203844978234
Amaranthus retroflexus,0,1,1,1.0,1.0
Amauropelta nevadensis,0,1,1,1.0,1.0
Ambesa laetella,0,1,1,1.0,1.0
Ambesa walsinghami,0,1,1,1.0,1.0
Amblyptilia pica,0,1,1,1.0,1.0
Ambrosia acanthicarpa,0,7,7,0.6034645370398923,0.5813304975648097
Ambystoma macrodactylum,0,44,44,0.0019256532943994855,0.011899006497493885
Ameiurus melas,0,1,1,1.0,1.0
Ameiurus nebulosus,0,3,3,1.0,1.0
Amelanchier alnifolia,0,39,39,0.0046877939621657125,0.019179555698833974
Amelanchier pumila,0,1,1,1.0,1.0
Amelanchier ramosissima,0,12,12,0.2360424886052977,0.31009055076592434
Amelanchier utahensis,0,87,87,1.989895997300706e-06,0.00022784221589992992
Ammannia coccinea,1,0,1,0.14476460320460613,0.3126936942061339
Amorbia cuneanum,0,1,1,1.0,1.0
Ampedus occidentalis,0,3,3,1.0,1.0
Amphiagrion abbreviatum,1,14,15,0.7118339050632088,0.6221922979706558
Amphibolips quercuspomiformis,1,1,2,0.2685730424867646,0.6723203844978234
Amphigerontia bifasciata,0,1,1,1.0,1.0
Amphipyra pyramidoides,3,4,7,0.0674516701814297,0.11027569540283454
Amphispiza bilineata,2,2,4,0.10278607328810296,0.1906437976216683
Amphitornus coloradus,0,1,1,1.0,1.0
Amsinckia menziesii,1,0,1,0.14476460320460613,0.3126936942061339
Anabrus simplex,0,10,10,0.3757244358299004,0.39438447212016514
Anaphalis margaritacea,0,203,203,2.3224621217195756e-14,8.160994417694096e-09
Anarta sierrae,0,2,2,1.0,1.0
Anas acuta,0,2,2,1.0,1.0
Anas carolinensis,0,2,2,1.0,1.0
Anas crecca,0,7,7,0.6034645370398923,0.5813304975648097
Anas platyrhynchos,31,205,236,0.6432841966602267,0.6218605846208944
Anaspis collaris,0,1,1,1.0,1.0
Anaspis rufa,0,1,1,1.0,1.0
Anastrangalia laetifica,41,56,97,3.1198404068571227e-11,2.23004414571018e-14
Anastrangalia sanguinea,0,24,24,0.03967208129449859,0.08442030606095953
Anatis lecontei,0,1,1,1.0,1.0
Anatis mali,0,1,1,1.0,1.0
Anatis rathvoni,3,88,91,0.000864288494357245,0.003943408221803489
Anatralata versicolor,0,4,4,1.0,0.9105509465652237
Anax junius,9,22,31,0.03557247261806539,0.040540437573388155
Anaxyrus boreas,43,185,228,0.07270542525959905,0.0737920622436699
Anaxyrus canorus,0,169,169,5.840221728164963e-12,1.5933723715190062e-07
Anaxyrus exsul,16,33,49,0.001514413698883397,0.0006413625761182602
Ancistrocerus adiabatus,0,1,1,1.0,1.0
Ancistrocerus bustamente,0,1,1,1.0,1.0
Ancistrocerus tuberculocephalus,1,0,1,0.14476460320460613,0.3126936942061339
Ancotrema zopherum,1,0,1,0.14476460320460613,0.3126936942061339
Ancylis columbiana,1,3,4,0.4650164385481151,1.0
Andersonglossum occidentale,2,41,43,0.08007004786506261,0.10640855030491529
Andrena auricoma,0,2,2,1.0,1.0
Andrena prunorum,1,4,5,0.5424646889787644,1.0
Andrena transnigra,0,1,1,1.0,1.0
Andrenosoma hesperium,1,0,1,0.14476460320460613,0.3126936942061339
Andricus quercuscalifornicus,10,4,14,2.3010529812760674e-06,1.3738561767643127e-08
Andropolia theodori,0,1,1,1.0,1.0
Aneflomorpha lineare,0,1,1,1.0,1.0
Aneides lugubris,2,2,4,0.10278607328810296,0.1906437976216683
Anelastes drurii,0,1,1,1.0,1.0
Anelsonia eurycarpa,0,1,1,1.0,1.0
Anemone blanda,3,2,5,0.02413002787627292,0.023975245305455268
Anemone drummondii,0,25,25,0.04095412181173697,0.07622457957144455
Anemone oregana,2,0,2,0.0209561639230412,0.01499159650771353
Anemopsis californica,2,1,3,0.056801432979852025,0.0803492820202322
Angelica breweri,0,106,106,1.007902773910342e-07,4.150537888657731e-05
Angelica capitellata,11,577,588,3.9748103662318755e-26,5.547653481316674e-18
Angelica kingii,1,5,6,1.0,1.0
Angelica lineariloba,5,88,93,0.01118610694424729,0.018909826620036655
Anisocarpus madioides,6,2,8,0.00019772693610894856,1.2839299064071593e-05
Anisocoma acaulis,9,7,16,0.00012072743957282779,1.1140523216937747e-05
Anisodactylus similis,0,1,1,1.0,1.0
Anisosticta bitriangularis,0,1,1,1.0,1.0
Annaphila danistica,0,3,3,1.0,1.0
Annaphila decia,3,0,3,0.0030335293929702875,0.000700171082788584
Annaphila depicta,2,3,5,0.15522343689242213,0.32387652224382535
Annaphila diva,6,13,19,0.04622915715125239,0.07301310260852441
Annaphila lithosina,0,1,1,1.0,1.0
Anniella campi,1,1,2,0.2685730424867646,0.6723203844978234
Annulohypoxylon thouarsianum,12,3,15,2.503062211953165e-08,7.616804796649087e-12
Anomobryum julaceum,2,0,2,0.0209561639230412,0.01499159650771353
Anomoporia bombycina,0,1,1,1.0,1.0
Anopheles freeborni,0,1,1,1.0,1.0
Anopheles punctipennis,0,1,1,1.0,1.0
Anser albifrons,0,1,1,1.0,1.0
Anser anser,2,0,2,0.0209561639230412,0.01499159650771353
Anser caerulescens,2,4,6,0.21128172197002185,0.4637992200137968
Anser cygnoides,1,0,1,0.14476460320460613,0.3126936942061339
Anstenoptilia marmarodactyla,1,3,4,0.4650164385481151,1.0
Antaeotricha manzanitae,0,1,1,1.0,1.0
Antennaria argentea,0,12,12,0.2360424886052977,0.31009055076592434
Antennaria corymbosa,0,2,2,1.0,1.0
Antennaria dimorpha,2,6,8,0.3262180684327187,0.7311980927864552
Antennaria geyeri,0,4,4,1.0,0.9105509465652237
Antennaria media,0,6,6,0.6025804396089913,0.6688993551184468
Antennaria pulchella,0,2,2,1.0,1.0
Antennaria rosea,2,64,66,0.0044518145280193645,0.013577244870925645
Antennaria umbrinella,0,1,1,1.0,1.0
Anthaxia caseyi,0,4,4,1.0,0.9105509465652237
Anthaxia inornata,1,0,1,0.14476460320460613,0.3126936942061339
Anthaxia prasina,1,0,1,0.14476460320460613,0.3126936942061339
Anthemis cotula,1,0,1,0.14476460320460613,0.3126936942061339
Antheraea polyphemus,16,14,30,7.00120131601711e-07,7.0556522789041155e-09
Anthidium maculosum,0,1,1,1.0,1.0
Anthidium manicatum,1,0,1,0.14476460320460613,0.3126936942061339
Anthocharis julia,0,28,28,0.02673836112705098,0.056309179680095994
Anthocharis lanceolata,0,12,12,0.2360424886052977,0.31009055076592434
Anthocharis sara,5,30,35,1.0,1.0
Anthophora terminalis,0,3,3,1.0,1.0
Anthophora urbana,5,48,53,0.4324142582831296,0.3963129104423645
Anthoxanthum odoratum,1,1,2,0.2685730424867646,0.6723203844978234
Anthracobia melaloma,0,12,12,0.2360424886052977,0.31009055076592434
Anthrax analis,0,1,1,1.0,1.0
Anthrenus lepidus,1,7,8,1.0,1.0
Anthrenus verbasci,2,2,4,0.10278607328810296,0.1906437976216683
Anthriscus caucalis,2,1,3,0.056801432979852025,0.0803492820202322
Anthus rubescens,1,7,8,1.0,1.0
Antilocapra americana,0,2,2,1.0,1.0
Antirrhinum majus,0,1,1,1.0,1.0
Antitrichia californica,0,2,2,1.0,1.0
Antrodiella pallasii,0,1,1,1.0,1.0
Antrozous pallidus,1,6,7,1.0,1.0
Anuroctonus phaiodactylus,1,2,3,0.3744588472376553,0.9141432822130974
Anuroctonus pococki,0,1,1,1.0,1.0
Apache californicum,1,0,1,0.14476460320460613,0.3126936942061339
Apamea amputatrix,1,0,1,0.14476460320460613,0.3126936942061339
Apamea cuculliformis,0,1,1,1.0,1.0
Apamea tahoeensis,0,1,1,1.0,1.0
Aphaenogaster occidentalis,4,11,15,0.25727213274247385,0.32960047615951354
Aphanes arvensis,1,0,1,0.14476460320460613,0.3126936942061339
Aphelocoma californica,58,21,79,5.919506618227144e-32,4.0257507861400104e-49
Aphelocoma woodhouseii,0,8,8,0.6124215574698968,0.5084255632839996
Aphis ceanothi,1,1,2,0.2685730424867646,0.6723203844978234
Aphis cercocarpi,0,1,1,1.0,1.0
Aphis nerii,4,1,5,0.0019413025415773043,0.00041787713651955216
Aphodius fimetarius,0,1,1,1.0,1.0
Aphonopelma johnnycashi,1,3,4,0.4650164385481151,1.0
Aphorista laeta,0,1,1,1.0,1.0
Aphorista morosa,0,2,2,1.0,1.0
Aphyllon californicum,2,4,6,0.21128172197002185,0.4637992200137968
Aphyllon corymbosum,1,24,25,0.2476906644158463,0.22836298286850215
Aphyllon epigalium,3,7,10,0.16639035724257725,0.3442511672283348
Aphyllon fasciculatum,0,5,5,1.0,0.7760428250025136
Aphyllon franciscanum,15,24,39,0.00020065061243825806,5.5821243119905304e-05
Aphyllon parishii,1,0,1,0.14476460320460613,0.3126936942061339
Aphyllon uniflorum,11,34,45,0.08510222096126735,0.09126978494202159
Apiomerus californicus,4,2,6,0.005153189017352294,0.0022646484484871816
Apioperdon pyriforme,0,2,2,1.0,1.0
Apiosporina morbosa,2,0,2,0.0209561639230412,0.01499159650771353
Apis mellifera,38,189,227,0.3446209199382839,0.3813261194425256
Aplodontia rufa,1,2,3,0.3744588472376553,0.9141432822130974
Apocynum androsaemifolium,41,556,597,9.107404047103558e-09,1.664773476302819e-07
Apocynum cannabinum,0,11,11,0.38449278358904854,0.3492157200022511
Aporus luxus,0,1,1,1.0,1.0
Apotomis removana,0,1,1,1.0,1.0
Apteroloma tahoecum,0,2,2,1.0,1.0
Aquarius remigis,23,113,136,0.3947268534193701,0.4930125245693453
Aquila chrysaetos,3,24,27,0.7886865336637121,0.8231296973634802
Aquilegia formosa,130,1706,1836,7.77423707600475e-23,1.9652896158448092e-19
Aquilegia pubescens,2,136,138,1.8551883888532588e-07,2.339198501785404e-05
Arabidopsis thaliana,0,4,4,1.0,0.9105509465652237
Arachnopeziza aurelia,0,1,1,1.0,1.0
Aradus behrensi,0,1,1,1.0,1.0
Aradus debilis,0,1,1,1.0,1.0
Aradus lugubris,0,1,1,1.0,1.0
Aradus patibulus,1,0,1,0.14476460320460613,0.3126936942061339
Aralia californica,12,33,45,0.03103919593763423,0.034648064398957755
Araneus bispinosus,0,1,1,1.0,1.0
Araneus gemma,1,0,1,0.14476460320460613,0.3126936942061339
Araneus gemmoides,2,2,4,0.10278607328810296,0.1906437976216683
Araniella displicata,4,21,25,0.7763237708742521,1.0
Arbutus menziesii,235,108,343,4.095727723118287e-114,2.686344071984761e-177
Arceuthobium abietinum,0,22,22,0.06301881478000051,0.10376364830846786
Arceuthobium americanum,0,13,13,0.23752623411074927,0.27601031745794824
Arceuthobium campylopodum,11,61,72,0.8665414039913187,0.9794348745940242
Arceuthobium divaricatum,0,1,1,1.0,1.0
Archilestes californicus,2,0,2,0.0209561639230412,0.01499159650771353
Archilestes grandis,6,14,20,0.0582140642887603,0.09785185992898056
Archilochus alexandri,4,4,8,0.01886984470142184,0.01861366248431812
Archips argyrospila,1,2,3,0.3744588472376553,0.9141432822130974
Archirhoe neomexicana,0,1,1,1.0,1.0
Archoplites interruptus,0,2,2,1.0,1.0
Arctia tigrina,0,1,1,1.0,1.0
Arctostaphylos manzanita,4,1,5,0.0019413025415773043,0.00041787713651955216
Arctostaphylos mewukka,18,44,62,0.0030794083927930547,0.0020887425406925834
Arctostaphylos nevadensis,4,399,403,6.0731649352257785e-22,2.3480902124753622e-14
Arctostaphylos nissenana,7,10,17,0.006793613907534162,0.005366650789691497
Arctostaphylos parryana,1,0,1,0.14476460320460613,0.3126936942061339
Arctostaphylos patula,26,930,956,1.2149404321591453e-34,6.347355365340245e-25
Arctostaphylos uva-ursi,0,3,3,1.0,1.0
Arctostaphylos viscida,185,254,439,6.739776195789915e-45,1.2898709254666745e-60
Arcyria denudata,0,1,1,1.0,1.0
Arcyria versicolor,0,50,50,0.0008358351626706249,0.006757170935664538
Ardea alba,3,2,5,0.02413002787627292,0.023975245305455268
Ardea herodias,9,20,29,0.02872505965523848,0.023180360862768038
Arenaria serpyllifolia,0,1,1,1.0,1.0
Argemone corymbosa,0,1,1,1.0,1.0
Argemone munita,2,27,29,0.4236909029353637,0.37010633316578956
Argia emma,5,14,19,0.18025928610181918,0.2539885128379542
Argia lugens,10,4,14,2.3010529812760674e-06,1.3738561767643127e-08
Argia vivida,26,65,91,0.0004759901216201176,0.00023955006009154008
Argiope aurantia,10,0,10,4.0368220512681146e-09,4.586479508074135e-13
Argiope trifasciata,1,1,2,0.2685730424867646,0.6723203844978234
Argynnis coronis,0,28,28,0.02673836112705098,0.056309179680095994
Argyrochosma jonesii,1,1,2,0.2685730424867646,0.6723203844978234
Arhopalus asperatus,0,5,5,1.0,0.7760428250025136
Arhopalus productus,0,1,1,1.0,1.0
Ariolimax buttoni,71,95,166,1.1360330812556113e-18,1.128505646368257e-24
Arizona elegans,0,1,1,1.0,1.0
Armadillidium vulgare,11,3,14,1.388223409795988e-07,1.224996553116888e-10
Armillaria mellea,6,5,11,0.002201136146005925,0.0008124952796229928
Armillaria nabsnona,0,1,1,1.0,1.0
Armillaria sinapina,2,6,8,0.3262180684327187,0.7311980927864552
Arnica chamissonis,0,4,4,1.0,0.9105509465652237
Arnica cordifolia,0,22,22,0.06301881478000051,0.10376364830846786
Arnica dealbata,0,3,3,1.0,1.0
Arnica discoidea,2,16,18,1.0,0.9435167712853587
Arnica lanceolata,0,3,3,1.0,1.0
Arnica latifolia,0,4,4,1.0,0.9105509465652237
Arnica longifolia,0,3,3,1.0,1.0
Arnica mollis,0,12,12,0.2360424886052977,0.31009055076592434
Arnica nevadensis,0,2,2,1.0,1.0
Arnica parryi,0,7,7,0.6034645370398923,0.5813304975648097
Aroga paraplutella,0,1,1,1.0,1.0
Aronia melanocarpa,0,1,1,1.0,1.0
Arphia behrensi,6,9,15,0.014202389485018597,0.014582554383236133
Arphia ramona,1,2,3,0.3744588472376553,0.9141432822130974
Arrhenia epichysium,0,3,3,1.0,1.0
Arrhenia juncorum,1,0,1,0.14476460320460613,0.3126936942061339
Arrhenia latispora,0,1,1,1.0,1.0
Arrhenia lobata,0,3,3,1.0,1.0
Arrhenia obscurata,0,2,2,1.0,1.0
Arrhenia retiruga,2,0,2,0.0209561639230412,0.01499159650771353
Arsapnia tumida,0,1,1,1.0,1.0
Arta epicoenalis,0,2,2,1.0,1.0
Artemia monica,0,9,9,0.37460992252836506,0.4468858706621094
Artemisia albicans,0,3,3,1.0,1.0
Artemisia arbuscula,0,2,2,1.0,1.0
Artemisia cana,0,4,4,1.0,0.9105509465652237
Artemisia douglasiana,69,114,183,8.141472381771203e-15,1.0517762948071277e-18
Artemisia dracunculus,1,10,11,1.0,0.9368824658167821
Artemisia ludoviciana,0,32,32,0.010653294055563268,0.03786379733207584
Artemisia michauxiana,0,2,2,1.0,1.0
Artemisia norvegica,0,7,7,0.6034645370398923,0.5813304975648097
Artemisia nova,1,22,23,0.23832747917939356,0.27824213268427256
Artemisia potentilloides,0,4,4,1.0,0.9105509465652237
Artemisia rothrockii,1,8,9,1.0,1.0
Artemisia spiciformis,0,2,2,1.0,1.0
Artemisia tridentata,11,138,149,0.01031228579063034,0.019005036255200506
Artemisiospiza belli,0,1,1,1.0,1.0
Artemisiospiza nevadensis,0,2,2,1.0,1.0
Arthuriomyces peckianus,8,4,12,5.508489772806841e-05,2.266634219630844e-06
Arum italicum,3,1,4,0.010816792675262966,0.00633924523846032
Asarum hartwegii,119,297,416,1.3071458078836337e-13,4.3259272298306395e-16
Asarum lemmonii,4,51,55,0.17674978101050592,0.18454115281437056
Ascalapha odorata,1,0,1,0.14476460320460613,0.3126936942061339
Asclepias californica,10,19,29,0.00575030288318706,0.005138254246980404
Asclepias cordifolia,148,314,462,1.1786838707158042e-21,1.3750679736016507e-26
Asclepias eriocarpa,30,16,46,5.810320012998248e-15,1.0470621921304182e-21
Asclepias fascicularis,42,25,67,2.0380544419022495e-19,2.3613024351867615e-28
Asclepias speciosa,44,181,225,0.036491001869290406,0.038295894337980405
Asclepias tuberosa,1,0,1,0.14476460320460613,0.3126936942061339
Asemoplus sierranus,0,2,2,1.0,1.0
Asemosyrphus polygrammus,2,4,6,0.21128172197002185,0.4637992200137968
Asemum nitidum,1,5,6,1.0,1.0
Asemum striatum,0,1,1,1.0,1.0
Aseptis lichena,0,2,2,1.0,1.0
Aseptis marina,2,0,2,0.0209561639230412,0.01499159650771353
Asio otus,0,8,8,0.6124215574698968,0.5084255632839996
Askellia pygmaea,0,1,1,1.0,1.0
Asparagus officinalis,1,0,1,0.14476460320460613,0.3126936942061339
Asphondylia garryae,1,5,6,1.0,1.0
Aspicilia angelica,0,1,1,1.0,1.0
Aspicilia phaea,0,1,1,1.0,1.0
Aspidoscelis tigris,11,15,26,0.0005438717163080941,0.00017353448137961958
Aspidotis californica,4,0,4,0.00043910829886184923,3.314336839661014e-05
Aspidotis carlotta-halliae,0,1,1,1.0,1.0
Aspidotis densa,20,87,107,0.2158751974868371,0.2704233321079056
Asterella bolanderi,5,3,8,0.0024244129099057063,0.0007850786162003298
Asterella californica,2,0,2,0.0209561639230412,0.01499159650771353
Asterella palmeri,1,1,2,0.2685730424867646,0.6723203844978234
Asteromyia carbonifera,0,1,1,1.0,1.0
Astraeus pteridis,0,5,5,1.0,0.7760428250025136
Astragalus andersonii,1,3,4,0.4650164385481151,1.0
Astragalus argophyllus,1,2,3,0.3744588472376553,0.9141432822130974
Astragalus austiniae,0,5,5,1.0,0.7760428250025136
Astragalus bolanderi,1,53,54,0.003350374749947845,0.01454402666214829
Astragalus calycosus,1,23,24,0.24143280901572373,0.25202843593319213
Astragalus canadensis,0,3,3,1.0,1.0
Astragalus casei,1,0,1,0.14476460320460613,0.3126936942061339
Astragalus cicer,0,17,17,0.15747128520432685,0.17645428752866515
Astragalus coccineus,1,0,1,0.14476460320460613,0.3126936942061339
Astragalus douglasii,2,0,2,0.0209561639230412,0.01499159650771353
Astragalus ertterae,2,1,3,0.056801432979852025,0.0803492820202322
Astragalus inyoensis,4,15,19,0.3433139456279959,0.6250673019802819
Astragalus johannis-howellii,0,1,1,1.0,1.0
Astragalus kentrophyta,1,20,21,0.3485544901265487,0.3394968187912247
Astragalus lemmonii,0,2,2,1.0,1.0
Astragalus lentiformis,0,1,1,1.0,1.0
Astragalus lentiginosus,3,61,64,0.020464263106306606,0.040527318305381976
Astragalus malacus,0,9,9,0.37460992252836506,0.4468858706621094
Astragalus minthorniae,1,12,13,0.7073310728950297,0.7633631983104203
Astragalus monoensis,0,11,11,0.38449278358904854,0.3492157200022511
Astragalus newberryi,0,13,13,0.23752623411074927,0.27601031745794824
Astragalus oophorus,2,4,6,0.21128172197002185,0.4637992200137968
Astragalus platytropis,1,5,6,1.0,1.0
Astragalus pulsiferae,1,0,1,0.14476460320460613,0.3126936942061339
Astragalus purshii,15,41,56,0.013304404297471645,0.01516786253922933
Astragalus sepultipes,1,0,1,0.14476460320460613,0.3126936942061339
Astragalus serenoi,3,2,5,0.02413002787627292,0.023975245305455268
Astragalus subvestitus,1,1,2,0.2685730424867646,0.6723203844978234
Astragalus whitneyi,0,16,16,0.15161267346782015,0.19687992504129675
Atalopedes campestris,1,0,1,0.14476460320460613,0.3126936942061339
Athene cunicularia,0,2,2,1.0,1.0
Atheniella adonis,1,3,4,0.4650164385481151,1.0
Atheniella aurantiidisca,3,0,3,0.0030335293929702875,0.000700171082788584
Atheniella delectabilis,0,4,4,1.0,0.9105509465652237
Atheniella flavoalba,0,2,2,1.0,1.0
Athyrium americanum,0,17,17,0.15747128520432685,0.17645428752866515
Athyrium cyclosorum,2,36,38,0.16129779019077917,0.16644259216844146
Athyrium filix-femina,1,65,66,0.0006782660188660858,0.004830215650732611
Athysanus pusillus,3,12,15,0.46864155961299403,0.8094879786929297
Atimia confusa,1,2,3,0.3744588472376553,0.9141432822130974
Atlides halesus,3,4,7,0.0674516701814297,0.11027569540283454
Atocion armeria,0,2,2,1.0,1.0
Atriplex canescens,1,0,1,0.14476460320460613,0.3126936942061339
Atriplex confertifolia,0,1,1,1.0,1.0
Atriplex parryi,1,0,1,0.14476460320460613,0.3126936942061339
Attagenus schaefferi,0,2,2,1.0,1.0
Atypoides riversi,11,22,33,0.005155183239822379,0.004633510310361492
Aulacomnium androgynum,3,6,9,0.12984024511270734,0.25675213762300036
Aulacomnium palustre,0,2,2,1.0,1.0
Aulospermum aboriginum,1,23,24,0.24143280901572373,0.25202843593319213
Aulospermum cinerarium,0,7,7,0.6034645370398923,0.5813304975648097
Auricularia americana,5,5,10,0.008469540260789258,0.0060826780961133285
Auriscalpium vulgare,17,14,31,1.831736979634638e-07,8.675710962484893e-10
Autographa californica,1,1,2,0.2685730424867646,0.6723203844978234
Autographa metallica,0,2,2,1.0,1.0
Aythya affinis,0,2,2,1.0,1.0
Aythya americana,0,1,1,1.0,1.0
Aythya collaris,4,4,8,0.01886984470142184,0.01861366248431812
Baccharis pilularis,26,1,27,3.461145776951474e-21,3.4613862601057854e-32
Baccharis salicifolia,1,0,1,0.14476460320460613,0.3126936942061339
Bactericera cockerelli,0,1,1,1.0,1.0
Bactericera salicivora,0,1,1,1.0,1.0
Baeolophus inornatus,61,11,72,3.3460581827381223e-40,3.6844762278911223e-63
Baeolophus ridgwayi,0,5,5,1.0,0.7760428250025136
Baeospora occidentalis,0,1,1,1.0,1.0
Bagrada hilaris,2,0,2,0.0209561639230412,0.01499159650771353
Balsamorhiza deltoidea,3,5,8,0.09660076546782431,0.17754400284199642
Balsamorhiza hookeri,0,9,9,0.37460992252836506,0.4468858706621094
Banasa dimidiata,2,2,4,0.10278607328810296,0.1906437976216683
Banasa sordida,1,1,2,0.2685730424867646,0.6723203844978234
Barbarea orthoceras,2,30,32,0.3096503613044311,0.2839708921279542
Barkworthia stillmanii,0,2,2,1.0,1.0
Bassaniana utahensis,1,0,1,0.14476460320460613,0.3126936942061339
Bassariscus astutus,10,4,14,2.3010529812760674e-06,1.3738561767643127e-08
Batrachoseps altasierrae,2,1,3,0.056801432979852025,0.0803492820202322
Batrachoseps attenuatus,6,2,8,0.00019772693610894856,1.2839299064071593e-05
Batrachoseps bramei,0,1,1,1.0,1.0
Batrachoseps diabolicus,1,0,1,0.14476460320460613,0.3126936942061339
Batrachoseps gregarius,9,2,11,1.1607551894565098e-06,3.2337159071325644e-09
Batrachoseps kawia,1,1,2,0.2685730424867646,0.6723203844978234
Batrachoseps regius,0,4,4,1.0,0.9105509465652237
Batrachoseps relictus,1,0,1,0.14476460320460613,0.3126936942061339
Batrachoseps robustus,0,3,3,1.0,1.0
Battus philenor,95,3,98,1.5352638146856495e-75,1.1013695391765286e-117
Bdellozonium cerviculatum,2,3,5,0.15522343689242213,0.32387652224382535
Beauveria pseudobassiana,0,1,1,1.0,1.0
Bebbia juncea,1,0,1,0.14476460320460613,0.3126936942061339
Beckwithia andersonii,7,10,17,0.006793613907534162,0.005366650789691497
Bedellia somnulentella,0,1,1,1.0,1.0
Behrensia conchiformis,0,1,1,1.0,1.0
Bellemerea sanguinea,0,1,1,1.0,1.0
Bellis perennis,1,6,7,1.0,1.0
Belostoma flumineum,0,1,1,1.0,1.0
Bembidion indistinctum,0,3,3,1.0,1.0
Bembidion iridescens,0,3,3,1.0,1.0
Bembidion mutatum,0,1,1,1.0,1.0
Bembidion orion,0,1,1,1.0,1.0
Bembidion quadrimaculatum,0,4,4,1.0,0.9105509465652237
Bembidion satelles,0,4,4,1.0,0.9105509465652237
Bembidion semipunctatum,0,4,4,1.0,0.9105509465652237
Bembix americana,1,1,2,0.2685730424867646,0.6723203844978234
Bembix amoena,0,2,2,1.0,1.0
Berula erecta,1,1,2,0.2685730424867646,0.6723203844978234
Betula occidentalis,3,22,25,1.0,0.9460168149437689
Bibio albipennis,2,2,4,0.10278607328810296,0.1906437976216683
Bibio vestitus,0,1,1,1.0,1.0
Bibio xanthopus,0,3,3,1.0,1.0
Bicyrtes capnopterus,0,1,1,1.0,1.0
Bidens frondosa,4,3,7,0.0106471288054473,0.007559096939159896
Biston betularia,0,1,1,1.0,1.0
Biston sinuata,2,0,2,0.0209561639230412,0.01499159650771353
Bistorta bistortoides,2,266,268,1.0032045840550245e-15,2.8717373012357615e-10
Bittacus chlorostigma,4,5,9,0.030121806187693938,0.03739180706614353
Blaniulus guttulatus,0,1,1,1.0,1.0
Blennogeneris spissipes,0,23,23,0.06652127337221461,0.09355974164186621
Blepharipappus scaber,0,1,1,1.0,1.0
Blera humeralis,0,2,2,1.0,1.0
Blera scitula,0,20,20,0.10203106758234803,0.12794167189413608
Blitum californicum,1,0,1,0.14476460320460613,0.3126936942061339
Blitum nuttallianum,0,1,1,1.0,1.0
Bloomeria crocea,2,1,3,0.056801432979852025,0.0803492820202322
Boechera arcuata,5,4,9,0.004804892843884087,0.0024551155675152643
Boechera bodiensis,0,1,1,1.0,1.0
Boechera davidsonii,0,4,4,1.0,0.9105509465652237
Boechera holboellii,0,1,1,1.0,1.0
Boechera howellii,0,14,14,0.24486350799097997,0.24618548812479032
Boechera pendulina,0,1,1,1.0,1.0
Boechera pinetorum,0,3,3,1.0,1.0
Boechera platysperma,0,15,15,0.14994170356869613,0.21998124924271661
Boechera puberula,1,0,1,0.14476460320460613,0.3126936942061339
Boechera pygmaea,1,0,1,0.14476460320460613,0.3126936942061339
Boechera rectissima,0,1,1,1.0,1.0
Boechera retrofracta,0,8,8,0.6124215574698968,0.5084255632839996
Boechera shevockii,2,2,4,0.10278607328810296,0.1906437976216683
Boechera shockleyi,1,1,2,0.2685730424867646,0.6723203844978234
Boechera stricta,0,2,2,1.0,1.0
Boechera tiehmii,0,2,2,1.0,1.0
Boechera xylopoda,0,1,1,1.0,1.0
Boisea rubrolineata,9,19,28,0.014199500458381647,0.016922455686641368
Boisea trivittata,0,1,1,1.0,1.0
Bolandra californica,0,21,21,0.06152025756350138,0.11517086832716916
Bolbitius pallidus,0,1,1,1.0,1.0
Bolbitius reticulatus,2,2,4,0.10278607328810296,0.1906437976216683
Bolbitius titubans,5,1,6,0.00033535930364562256,2.5155693289996723e-05
Boletus barrowsii,0,3,3,1.0,1.0
Boletus edulis,3,119,122,1.4556021470514886e-05,0.0002675212891015843
Boletus fibrillosus,0,8,8,0.6124215574698968,0.5084255632839996
Boletus orovillus,3,0,3,0.0030335293929702875,0.000700171082788584
Boletus pinophilus,0,1,1,1.0,1.0
Boletus regineus,7,3,10,0.00010655132026942219,5.604574097560587e-06
Boletus rex-veris,3,95,98,0.0004332515365406517,0.0021489471296126284
Boletus subalpinus,0,4,4,1.0,0.9105509465652237
Boloria epithore,3,202,205,2.0123962126564973e-10,2.0074847660410358e-07
Bombus appositus,0,10,10,0.3757244358299004,0.39438447212016514
Bombus californicus,5,23,28,0.5898659840899363,0.8104259590832338
Bombus centralis,1,10,11,1.0,0.9368824658167821
Bombus crotchii,6,6,12,0.0038645835637426216,0.002020624115740119
Bombus fervidus,0,1,1,1.0,1.0
Bombus flavidus,0,11,11,0.38449278358904854,0.3492157200022511
Bombus flavifrons,1,15,16,0.4958553183213633,0.5619415773454699
Bombus huntii,0,7,7,0.6034645370398923,0.5813304975648097
Bombus insularis,3,19,22,1.0,1.0
Bombus kirbiellus,0,1,1,1.0,1.0
Bombus melanopygus,32,59,91,7.128986162740709e-07,4.730991159255358e-08
Bombus mixtus,0,18,18,0.0958116006335464,0.1583481410858158
Bombus morrisoni,2,13,15,1.0,1.0
Bombus nevadensis,0,4,4,1.0,0.9105509465652237
Bombus occidentalis,0,4,4,1.0,0.9105509465652237
Bombus rufocinctus,0,3,3,1.0,1.0
Bombus sylvicola,0,9,9,0.37460992252836506,0.4468858706621094
Bombus vancouverensis,0,57,57,0.00021966229870961306,0.0035185750074501754
Bombus vandykei,8,74,82,0.2722399191280951,0.29000739147105
Bombus vosnesenskii,50,358,408,0.2307791086452658,0.22774057174773596
Bombycilaena californica,8,2,10,6.5864666725043825e-06,5.342167245405184e-08
Bombycilla cedrorum,7,8,15,0.002928859390410695,0.0014910704758996124
Bombylius major,3,3,6,0.0431068667335647,0.05837521372070738
Bondarzewia occidentalis,0,4,4,1.0,0.9105509465652237
Borago officinalis,1,0,1,0.14476460320460613,0.3126936942061339
Boreonectes griseostriatus,0,1,1,1.0,1.0
Boreus californicus,0,1,1,1.0,1.0
Bos taurus,0,1,1,1.0,1.0
Botrychium ascendens,0,4,4,1.0,0.9105509465652237
Botrychium crenulatum,1,4,5,0.5424646889787644,1.0
Botrychium minganense,0,7,7,0.6034645370398923,0.5813304975648097
Botrychium montanum,0,1,1,1.0,1.0
Botrychium simplex,0,11,11,0.38449278358904854,0.3492157200022511
Botrytis cinerea,0,1,1,1.0,1.0
Bovista californica,0,4,4,1.0,0.9105509465652237
Bovista pila,0,1,1,1.0,1.0
Boykinia major,1,15,16,0.4958553183213633,0.5619415773454699
Boykinia occidentalis,2,9,11,0.6666373202113602,1.0
Brachycybe producta,16,12,28,1.9582333079653792e-07,7.832588748423679e-10
Brachycybe rosea,25,19,44,8.485909833883354e-11,7.92285864186385e-15
Brachyleptura vexatrix,0,1,1,1.0,1.0
Brachymelecta californica,1,20,21,0.3485544901265487,0.3394968187912247
Brachymyrmex depilis,2,0,2,0.0209561639230412,0.01499159650771353
Brachynemurus ferox,0,1,1,1.0,1.0
Brachynemurus sackeni,0,1,1,1.0,1.0
Brachysomida californica,1,1,2,0.2685730424867646,0.6723203844978234
Brachystoma occidentale,0,1,1,1.0,1.0
Bradynotes obesa,0,5,5,1.0,0.7760428250025136
Branta canadensis,54,115,169,8.44188468059774e-09,2.1504449733731013e-10
Branta hutchinsii,1,3,4,0.4650164385481151,1.0
Brasenia schreberi,0,12,12,0.2360424886052977,0.31009055076592434
Brasiliomyces trini,1,0,1,0.14476460320460613,0.3126936942061339
Brefeldia maxima,0,2,2,1.0,1.0
Brephidium exilis,3,5,8,0.09660076546782431,0.17754400284199642
Brewerimitella breweri,0,103,103,1.5404721426942346e-07,5.424957102769321e-05
Brickellia californica,7,4,11,0.00025616982714586243,2.60591529641861e-05
Brickellia grandiflora,1,11,12,1.0,0.845714857147599
Brickellia greenei,0,2,2,1.0,1.0
Brickellia microphylla,1,1,2,0.2685730424867646,0.6723203844978234
Brickellia oblongifolia,2,4,6,0.21128172197002185,0.4637992200137968
Briza maxima,14,1,15,2.2970506110575563e-11,9.312237791943351e-17
Briza minor,6,2,8,0.00019772693610894856,1.2839299064071593e-05
Brodiaea elegans,44,95,139,3.290423148453999e-07,1.7270643233201086e-08
Brodiaea insignis,0,1,1,1.0,1.0
Brodiaea minor,6,3,9,0.0005200289628174682,7.003163864249939e-05
Brodiaea sierrae,9,4,13,1.1427959821928325e-05,1.820984079580061e-07
Brodiaea terrestris,1,1,2,0.2685730424867646,0.6723203844978234
Bromius obscurus,0,2,2,1.0,1.0
Bromus carinatus,1,6,7,1.0,1.0
Bromus diandrus,2,2,4,0.10278607328810296,0.1906437976216683
Bromus hordeaceus,2,1,3,0.056801432979852025,0.0803492820202322
Bromus inermis,0,9,9,0.37460992252836506,0.4468858706621094
Bromus marginatus,0,2,2,1.0,1.0
Bromus orcuttianus,1,0,1,0.14476460320460613,0.3126936942061339
Bromus rubens,2,2,4,0.10278607328810296,0.1906437976216683
Bromus suksdorfii,0,3,3,1.0,1.0
Bromus tectorum,4,37,41,0.5081741709490661,0.5240320746211788
Bromus vulgaris,1,0,1,0.14476460320460613,0.3126936942061339
Brothylus conspersus,0,1,1,1.0,1.0
Brothylus gemmulatus,0,2,2,1.0,1.0
Bruchia bolanderi,0,1,1,1.0,1.0
Brumoides histrio,0,2,2,1.0,1.0
Bruneria shastana,0,1,1,1.0,1.0
Bryoglossum gracile,0,2,2,1.0,1.0
Bryum argenteum,2,0,2,0.0209561639230412,0.01499159650771353
Bubo virginianus,10,44,54,0.4363022996518493,0.5151267124430494
Bubulcus ibis,0,1,1,1.0,1.0
Bucephala albeola,6,31,37,0.8140164913670949,0.9464615783811715
Bucephala clangula,3,10,13,0.41916983303031286,0.626122924488651
Bucephala islandica,2,0,2,0.0209561639230412,0.01499159650771353
Buddleja davidii,2,0,2,0.0209561639230412,0.01499159650771353
Bulbostylis capillaris,0,2,2,1.0,1.0
Bulgaria inquinans,6,1,7,5.640935459925577e-05,1.4388133744720056e-06
Buprestis adjecta,0,7,7,0.6034645370398923,0.5813304975648097
Buprestis aurulenta,9,81,90,0.2929499473871954,0.29033671356032553
Buprestis confluenta,0,2,2,1.0,1.0
Buprestis gibbsii,2,4,6,0.21128172197002185,0.4637992200137968
Buprestis intricata,0,6,6,0.6025804396089913,0.6688993551184468
Buprestis laeviventris,0,7,7,0.6034645370398923,0.5813304975648097
Buprestis langii,0,1,1,1.0,1.0
Buprestis lyrata,3,34,37,0.3537890097732401,0.38573136140241937
Buprestis prospera,0,1,1,1.0,1.0
Buprestis viridisuturalis,0,1,1,1.0,1.0
Burnsius communis,1,97,98,8.333299411090813e-06,0.00026932036053698116
Buteo jamaicensis,33,211,244,0.7845661711399923,0.7400371031619504
Buteo lineatus,34,32,66,1.5916368374928814e-12,5.37399739287395e-17
Buteo regalis,0,3,3,1.0,1.0
Buteo swainsoni,0,5,5,1.0,0.7760428250025136
Butorides virescens,3,0,3,0.0030335293929702875,0.000700171082788584
Butyriboletus abieticola,0,7,7,0.6034645370398923,0.5813304975648097
Butyriboletus autumniregius,0,1,1,1.0,1.0
Butyriboletus primiregius,0,12,12,0.2360424886052977,0.31009055076592434
Buxbaumia viridis,1,0,1,0.14476460320460613,0.3126936942061339
Cacopsylla notapennis,0,1,1,1.0,1.0
Caenurgina caerulea,0,7,7,0.6034645370398923,0.5813304975648097
Caenurgina erechtea,1,0,1,0.14476460320460613,0.3126936942061339
Cairina moschata,9,1,10,2.4259786172080083e-07,2.3235216610518305e-10
Calamagrostis canadensis,0,3,3,1.0,1.0
Calamagrostis muiriana,0,1,1,1.0,1.0
Calamagrostis purpurascens,0,1,1,1.0,1.0
Calandrinia menziesii,10,4,14,2.3010529812760674e-06,1.3738561767643127e-08
Calbovista subsculpta,3,66,69,0.015016492969201161,0.026388997481998223
Calicium pinicola,0,4,4,1.0,0.9105509465652237
Calicium viride,1,5,6,1.0,1.0
Calidris mauri,0,2,2,1.0,1.0
Calidris minutilla,0,2,2,1.0,1.0
Calidris virgata,0,1,1,1.0,1.0
Californiulus yosemitensis,1,64,65,0.0010868724805583544,0.005292122215611074
Calineuria californica,1,2,3,0.3744588472376553,0.9141432822130974
Calisoga longitarsis,12,45,57,0.18392491397080357,0.221333334008086
Callibaetis pictus,1,0,1,0.14476460320460613,0.3126936942061339
Callidium antennatum,0,1,1,1.0,1.0
Calligrapha sigmoidea,0,3,3,1.0,1.0
Callimoxys fuscipennis,8,11,19,0.00325413487701567,0.0019561111666591894
Callimoxys sanguinicollis,0,1,1,1.0,1.0
Callimus cyanipennis,1,2,3,0.3744588472376553,0.9141432822130974
Callinicus pictitarsis,0,1,1,1.0,1.0
Callinicus pollenius,0,5,5,1.0,0.7760428250025136
Callipepla californica,60,34,94,1.0016471125498182e-27,2.8535704371886124e-41
Callisaurus draconoides,2,0,2,0.0209561639230412,0.01499159650771353
Calliscirpus brachythrix,0,7,7,0.6034645370398923,0.5813304975648097
Callistosporium luteo-olivaceum,1,0,1,0.14476460320460613,0.3126936942061339
Callitriche palustris,0,1,1,1.0,1.0
Callobius gertschi,0,1,1,1.0,1.0
Callobius severus,0,2,2,1.0,1.0
Calloides lorquinii,0,1,1,1.0,1.0
Callophrys mossii,0,1,1,1.0,1.0
Callospermophilus lateralis,17,813,830,4.6766660728703434e-35,3.3832149913271466e-24
Caloboletus frustosus,0,13,13,0.23752623411074927,0.27601031745794824
Caloboletus marshii,2,0,2,0.0209561639230412,0.01499159650771353
Caloboletus rubripes,0,21,21,0.06152025756350138,0.11517086832716916
Calocedrus decurrens,271,1061,1332,5.246934807325097e-09,1.287286674005352e-09
Calocera cornea,10,4,14,2.3010529812760674e-06,1.3738561767643127e-08
Calocera viscosa,1,0,1,0.14476460320460613,0.3126936942061339
Calochortus albus,161,5,166,2.282945516549506e-127,3.0460471761834993e-199
Calochortus amoenus,16,50,66,0.03383995997209627,0.037501718144362664
Calochortus bruneaunis,12,70,82,1.0,1.0
Calochortus clavatus,2,42,44,0.08200829409183771,0.09729103346637974
Calochortus coeruleus,0,49,49,0.0008005248515112549,0.007422022401504626
Calochortus excavatus,8,4,12,5.508489772806841e-05,2.266634219630844e-06
Calochortus invenustus,20,22,42,3.2461465009588866e-07,3.964310643922136e-09
Calochortus kennedyi,2,2,4,0.10278607328810296,0.1906437976216683
Calochortus leichtlinii,39,1668,1707,3.017830156318971e-67,1.1741712867571466e-46
Calochortus luteus,1,0,1,0.14476460320460613,0.3126936942061339
Calochortus minimus,14,419,433,9.622088554887734e-15,4.45828017809337e-11
Calochortus monophyllus,258,264,522,9.410945042413368e-80,1.0905797352322143e-113
Calochortus nudus,0,13,13,0.23752623411074927,0.27601031745794824
Calochortus palmeri,2,3,5,0.15522343689242213,0.32387652224382535
Calochortus striatus,1,2,3,0.3744588472376553,0.9141432822130974
Calochortus superbus,22,17,39,1.3890612421095088e-09,5.364509989562903e-13
Calochortus tolmiei,21,8,29,3.0773416971676517e-12,7.70554220632325e-18
Calochortus venustus,77,59,136,4.50707083836424e-30,1.2741541943309503e-43
Calochortus westonii,8,16,24,0.01623231103652724,0.019516526412933367
Calocybe onychina,1,1,2,0.2685730424867646,0.6723203844978234
Calogaya saxicola,0,1,1,1.0,1.0
Calonarius adonis,0,1,1,1.0,1.0
Calonarius barbaricus,0,1,1,1.0,1.0
Calonarius bigelowii,0,3,3,1.0,1.0
Calonarius elotoides,0,2,2,1.0,1.0
Calonarius sannio,0,2,2,1.0,1.0
Calonarius verrucisporus,0,1,1,1.0,1.0
Calonarius xanthodryophilus,2,0,2,0.0209561639230412,0.01499159650771353
Caloptilia murtfeldtella,0,1,1,1.0,1.0
Calopus angustus,0,3,3,1.0,1.0
Caloscypha fulgens,12,284,296,7.057749572885776e-09,5.240645268443712e-07
Calosoma luxatum,0,2,2,1.0,1.0
Calosoma semilaeve,0,1,1,1.0,1.0
Caltha biflora,0,2,2,1.0,1.0
Caltha leptosepala,0,249,249,1.7258134044639412e-17,1.492633167610626e-10
Calvatia booniana,6,8,14,0.00969297744733247,0.00833304449065533
Calvatia gigantea,0,1,1,1.0,1.0
Calvatia sculpta,7,154,161,6.763115994327082e-05,0.00039718321007823975
Calycadenia multiglandulosa,14,3,17,7.793001379372598e-10,2.7538696494974022e-14
Calycadenia oppositifolia,5,6,11,0.013693210356916412,0.012717642011991449
Calycadenia truncata,5,5,10,0.008469540260789258,0.0060826780961133285
Calycanthus occidentalis,51,68,119,6.827946621324777e-14,4.278756119976472e-18
Calycina citrina,2,1,3,0.056801432979852025,0.0803492820202322
Calycina claroflava,1,0,1,0.14476460320460613,0.3126936942061339
Calycomyza artemisiae,0,1,1,1.0,1.0
Calycoseris parryi,1,3,4,0.4650164385481151,1.0
Calypogeia neogaea,0,1,1,1.0,1.0
Calypso bulbosa,0,1,1,1.0,1.0
Calypte anna,52,63,115,2.653637395469767e-15,2.4846282942850675e-20
Calypte costae,2,5,7,0.2688137426846044,0.6011437582684053
Calyptridium monandrum,1,1,2,0.2685730424867646,0.6723203844978234
Calyptridium monospermum,31,985,1016,2.9006079166517197e-34,5.050047605040991e-25
Calyptridium nevadense,0,2,2,1.0,1.0
Calyptridium pulchellum,0,1,1,1.0,1.0
Calyptridium umbellatum,1,51,52,0.004988545668220802,0.017503821408763356
Calystegia atriplicifolia,1,0,1,0.14476460320460613,0.3126936942061339
Calystegia malacophylla,1,21,22,0.3559263140695814,0.3072913058315549
Calystegia occidentalis,10,13,23,0.0007499745698379427,0.00025537986547645675
Calystegia stebbinsii,5,0,5,6.355973818199171e-05,1.5903757301150513e-06
Camassia leichtlinii,0,6,6,0.6025804396089913,0.6688993551184468
Camassia quamash,0,127,127,3.3670635673938547e-09,6.426298774252332e-06
Cameraria sempervirensella,0,2,2,1.0,1.0
Camissonia campestris,1,0,1,0.14476460320460613,0.3126936942061339
Camissonia contorta,0,2,2,1.0,1.0
Camissonia integrifolia,3,5,8,0.09660076546782431,0.17754400284199642
Camissonia kernensis,4,3,7,0.0106471288054473,0.007559096939159896
Camissonia parvula,0,2,2,1.0,1.0
Camissonia pusilla,2,3,5,0.15522343689242213,0.32387652224382535
Camissonia sierrae,1,21,22,0.3559263140695814,0.3072913058315549
Camnula pellucida,0,13,13,0.23752623411074927,0.27601031745794824
Campaea perlata,0,11,11,0.38449278358904854,0.3492157200022511
Campanula medium,0,1,1,1.0,1.0
Campanula persicifolia,0,2,2,1.0,1.0
Camponotus hyatti,0,2,2,1.0,1.0
Camponotus laevigatus,0,5,5,1.0,0.7760428250025136
Camponotus modoc,11,308,319,1.380760387638691e-10,3.336390036205234e-08
Camponotus nearcticus,0,1,1,1.0,1.0
Camponotus vicinus,8,32,40,0.3643055111564689,0.44235433678756775
Canbya candida,6,9,15,0.014202389485018597,0.014582554383236133
Candelariella rosulans,0,1,1,1.0,1.0
Candolleomyces candolleanus,4,2,6,0.005153189017352294,0.0022646484484871816
Canis latrans,54,242,296,0.06889000046836527,0.07831895093281652
Canis lupus,1,6,7,1.0,1.0
Cantharellus californicus,1,0,1,0.14476460320460613,0.3126936942061339
Cantharellus cascadensis,1,6,7,1.0,1.0
Cantharellus subalbidus,2,3,5,0.15522343689242213,0.32387652224382535
Capitotricha bicolor,0,10,10,0.3757244358299004,0.39438447212016514
Capnobotes attenuatus,1,0,1,0.14476460320460613,0.3126936942061339
Capnobotes fuliginosus,0,1,1,1.0,1.0
Capnobotes occidentalis,0,1,1,1.0,1.0
Capnocybe spongiosa,0,1,1,1.0,1.0
Capsella bursa-pastoris,5,8,13,0.029720034996664528,0.03904543059057355
Carabus taedatus,0,2,2,1.0,1.0
Carbonicola myrmecina,0,1,1,1.0,1.0
Cardamine breweri,0,35,35,0.0069115977543475066,0.028234654159491945
Cardamine californica,40,23,63,7.452853610497254e-19,1.4429984714182359e-27
Cardamine cordifolia,0,2,2,1.0,1.0
Cardamine hirsuta,9,3,12,4.040097077097204e-06,2.881081634006637e-08
Cardamine oligosperma,1,1,2,0.2685730424867646,0.6723203844978234
Cardamine pachystigma,0,4,4,1.0,0.9105509465652237
Cardamine pensylvanica,1,1,2,0.2685730424867646,0.6723203844978234
Cardellina pusilla,2,112,114,6.517725861224499e-06,0.00019268272177192872
Cardiophorus edwardsi,0,1,1,1.0,1.0
Carduus nutans,0,3,3,1.0,1.0
Carduus pycnocephalus,8,1,9,1.5113716238966603e-06,4.3344519411722725e-09
Carex amplifolia,0,2,2,1.0,1.0
Carex angustata,1,1,2,0.2685730424867646,0.6723203844978234
Carex athrostachya,0,8,8,0.6124215574698968,0.5084255632839996
Carex aurea,1,10,11,1.0,0.9368824658167821
Carex barbarae,1,0,1,0.14476460320460613,0.3126936942061339
Carex bolanderi,1,0,1,0.14476460320460613,0.3126936942061339
Carex capitata,0,7,7,0.6034645370398923,0.5813304975648097
Carex congdonii,0,3,3,1.0,1.0
Carex davyi,0,2,2,1.0,1.0
Carex deflexa,0,1,1,1.0,1.0
Carex densa,0,1,1,1.0,1.0
Carex diandra,0,1,1,1.0,1.0
Carex douglasii,0,4,4,1.0,0.9105509465652237
Carex feta,0,2,2,1.0,1.0
Carex filifolia,0,9,9,0.37460992252836506,0.4468858706621094
Carex fissuricola,0,2,2,1.0,1.0
Carex fracta,0,8,8,0.6124215574698968,0.5084255632839996
Carex geyeri,0,1,1,1.0,1.0
Carex heteroneura,0,8,8,0.6124215574698968,0.5084255632839996
Carex hirtissima,1,0,1,0.14476460320460613,0.3126936942061339
Carex hoodii,0,2,2,1.0,1.0
Carex infirminervia,0,2,2,1.0,1.0
Carex jonesii,1,1,2,0.2685730424867646,0.6723203844978234
Carex kelloggii,0,3,3,1.0,1.0
Carex laeviculmis,0,1,1,1.0,1.0
Carex lemmonii,0,2,2,1.0,1.0
Carex limosa,0,15,15,0.14994170356869613,0.21998124924271661
Carex luzulina,0,2,2,1.0,1.0
Carex multicaulis,2,8,10,0.6456440117183423,0.9624710515030661
Carex nebrascensis,1,0,1,0.14476460320460613,0.3126936942061339
Carex nudata,0,3,3,1.0,1.0
Carex pellita,0,7,7,0.6034645370398923,0.5813304975648097
Carex raynoldsii,0,3,3,1.0,1.0
Carex rossii,0,5,5,1.0,0.7760428250025136
Carex sartwelliana,0,1,1,1.0,1.0
Carex sheldonii,0,1,1,1.0,1.0
Carex spectabilis,0,1,1,1.0,1.0
Carex straminiformis,0,1,1,1.0,1.0
Carex subfusca,0,1,1,1.0,1.0
Carex subnigricans,0,1,1,1.0,1.0
Carex utriculata,0,25,25,0.04095412181173697,0.07622457957144455
Carex vesicaria,0,3,3,1.0,1.0
Carex whitneyi,0,5,5,1.0,0.7760428250025136
Carex xerophila,2,0,2,0.0209561639230412,0.01499159650771353
Caripeta aequaliaria,2,58,60,0.009286323014237026,0.023210232576616523
Carlquistia muirii,1,6,7,1.0,1.0
Carpenteria californica,5,4,9,0.004804892843884087,0.0024551155675152643
Carterocephalus skada,0,11,11,0.38449278358904854,0.3492157200022511
Cassiope mertensiana,0,93,93,8.604861371154454e-07,0.00013282250037546404
Castanea sativa,1,0,1,0.14476460320460613,0.3126936942061339
Castilleja affinis,3,0,3,0.0030335293929702875,0.000700171082788584
Castilleja angustifolia,0,2,2,1.0,1.0
Castilleja applegatei,20,398,418,3.31465034405034e-10,2.5797754400413807e-08
Castilleja arachnoidea,0,1,1,1.0,1.0
Castilleja attenuata,2,6,8,0.3262180684327187,0.7311980927864552
Castilleja chromosa,2,35,37,0.1582152487866142,0.1819901968120017
Castilleja densiflora,0,1,1,1.0,1.0
Castilleja disticha,2,31,33,0.21893835641553538,0.2598647020176285
Castilleja exserta,7,2,9,3.65759227530616e-05,8.499366410736652e-07
Castilleja foliolosa,1,1,2,0.2685730424867646,0.6723203844978234
Castilleja lacera,1,6,7,1.0,1.0
Castilleja lemmonii,0,133,133,1.432701324447865e-09,3.7805078890276833e-06
Castilleja linariifolia,1,34,35,0.052367644370852305,0.0866058549917146
Castilleja lineariloba,8,5,13,0.00012493599837919194,9.489826548441195e-06
Castilleja martini,1,0,1,0.14476460320460613,0.3126936942061339
Castilleja miniata,6,370,376,5.880705941861315e-18,2.038865519478751e-12
Castilleja minor,0,2,2,1.0,1.0
Castilleja nana,0,75,75,1.821468578761576e-05,0.000674876063074879
Castilleja parviflora,0,1,1,1.0,1.0
Castilleja peirsonii,0,18,18,0.0958116006335464,0.1583481410858158
Castilleja pilosa,0,19,19,0.09746384240092232,0.14226189947649115
Castilleja praeterita,1,13,14,0.7079821656760785,0.6890993041903317
Castilleja pruinosa,2,6,8,0.3262180684327187,0.7311980927864552
Castilleja subinclusa,2,2,4,0.10278607328810296,0.1906437976216683
Castilleja tenuis,0,51,51,0.0005177884379523655,0.006152910162560303
Castor canadensis,3,48,51,0.10776694907346221,0.12222990931488155
Catabena lineolata,0,1,1,1.0,1.0
Catastia actualis,0,3,3,1.0,1.0
Cathartes aura,41,58,99,6.767511899754719e-11,7.638396784417177e-14
Catharus fuscescens,0,1,1,1.0,1.0
Catharus guttatus,67,75,142,1.640917130614336e-20,5.866405204849354e-28
Catharus ustulatus,2,8,10,0.6456440117183423,0.9624710515030661
Catherpes mexicanus,2,9,11,0.6666373202113602,1.0
Catocala aholibah,1,5,6,1.0,1.0
Catocala californica,0,1,1,1.0,1.0
Catocala ilia,1,0,1,0.14476460320460613,0.3126936942061339
Catocala junctura,0,1,1,1.0,1.0
Catocala mcdunnoughi,1,0,1,0.14476460320460613,0.3126936942061339
Catocala piatrix,1,0,1,0.14476460320460613,0.3126936942061339
Catocala relicta,0,1,1,1.0,1.0
Catocala semirelicta,0,1,1,1.0,1.0
Catostomus fumeiventris,0,1,1,1.0,1.0
Catostomus occidentalis,2,3,5,0.15522343689242213,0.32387652224382535
Catostomus tahoensis,0,1,1,1.0,1.0
Caulorhiza umbonata,0,1,1,1.0,1.0
Ceanothia bicolor,1,0,1,0.14476460320460613,0.3126936942061339
Ceanothus arcuatus,0,2,2,1.0,1.0
Ceanothus cordulatus,12,747,759,1.6860202344892244e-35,7.92555899048312e-24
Ceanothus cuneatus,52,12,64,1.1399825485713265e-32,6.656633960008338e-51
Ceanothus divergens,0,1,1,1.0,1.0
Ceanothus diversifolius,7,15,22,0.03097097538511197,0.04455390557558185
Ceanothus fresnensis,2,4,6,0.21128172197002185,0.4637992200137968
Ceanothus integerrimus,111,287,398,5.131370302547167e-12,4.6545388804703944e-14
Ceanothus lemmonii,20,6,26,1.5381715543519688e-12,1.765654563899799e-18
Ceanothus leucodermis,2,2,4,0.10278607328810296,0.1906437976216683
Ceanothus lorenzenii,0,2,2,1.0,1.0
Ceanothus palmeri,1,0,1,0.14476460320460613,0.3126936942061339
Ceanothus parvifolius,5,167,172,6.678207120056837e-07,2.6023836564386877e-05
Ceanothus pauciflorus,4,6,10,0.044556650138771095,0.06510377152388026
Ceanothus pinetorum,3,9,12,0.3994183286503844,0.5314104390489738
Ceanothus prostratus,30,512,542,5.574989154365087e-11,4.544385756079488e-09
Ceanothus roderickii,2,0,2,0.0209561639230412,0.01499159650771353
Ceanothus tomentosus,2,3,5,0.15522343689242213,0.32387652224382535
Ceanothus velutinus,4,331,335,1.4554323845978612e-17,8.068280592491863e-12
Celastrina ladon,45,300,345,0.49097324415011223,0.49616708105381835
Centaurea australis,0,1,1,1.0,1.0
Centaurea cyanus,21,23,44,1.5732458131310605e-07,1.4057604724230043e-09
Centaurea melitensis,5,2,7,0.0010327341762908842,0.00018014051424031924
Centaurea montana,0,3,3,1.0,1.0
Centaurea solstitialis,16,9,25,2.0346146520432093e-08,1.4426908053107e-11
Centaurea stoebe,0,1,1,1.0,1.0
Centranthus ruber,7,0,7,1.3315701680073362e-06,3.775277184632102e-09
Centrocercus urophasianus,2,24,26,0.5732761753112863,0.4811289201701078
Centrochelys sulcata,0,1,1,1.0,1.0
Centrodera spurca,5,41,46,0.6742385669023431,0.6271185872643128
Centromadia fitchii,3,0,3,0.0030335293929702875,0.000700171082788584
Centrostegia thurberi,1,2,3,0.3744588472376553,0.9141432822130974
Cephalanthera austiniae,20,120,140,1.0,1.0
Cephalanthus occidentalis,9,0,9,2.7892926019110602e-08,9.215270667313031e-12
Ceraleptus pacificus,0,1,1,1.0,1.0
Cerastium arvense,0,1,1,1.0,1.0
Cerastium beeringianum,0,1,1,1.0,1.0
Cerastium fontanum,0,1,1,1.0,1.0
Cerastium glomeratum,3,0,3,0.0030335293929702875,0.000700171082788584
Cerastium holosteoides,0,4,4,1.0,0.9105509465652237
Cerastium tomentosum,0,1,1,1.0,1.0
Ceratiomyxa fruticulosa,3,24,27,0.7886865336637121,0.8231296973634802
Ceratocephala orthoceras,0,1,1,1.0,1.0
Ceratodalia gueneata,0,3,3,1.0,1.0
Ceratophyllum demersum,0,2,2,1.0,1.0
Cercis occidentalis,59,35,94,1.0212234199868178e-26,1.443982936053149e-39
Cercocarpus betuloides,43,13,56,2.05893136515026e-25,5.3090895737261425e-39
Cercocarpus intricatus,2,15,17,1.0,1.0
Cercocarpus ledifolius,12,211,223,2.338787455134013e-05,0.00016519585640527488
Cercyonis oetus,1,5,6,1.0,1.0
Cercyonis paulus,0,1,1,1.0,1.0
Cercyonis pegala,0,3,3,1.0,1.0
Cercyonis sthenele,1,17,18,0.5002083905620196,0.4588452058316618
Ceriana tridens,0,1,1,1.0,1.0
Cerinthe major,1,0,1,0.14476460320460613,0.3126936942061339
Cerioporus leptocephalus,1,1,2,0.2685730424867646,0.6723203844978234
Cerioporus squamosus,0,1,1,1.0,1.0
Cerioporus varius,2,1,3,0.056801432979852025,0.0803492820202322
Cerodontha dorsalis,0,1,1,1.0,1.0
Cerrena unicolor,0,1,1,1.0,1.0
Certhia americana,21,249,270,0.000968423504876436,0.0023359499248207624
Ceruchus punctatus,1,5,6,1.0,1.0
Cervus elaphus,2,4,6,0.21128172197002185,0.4637992200137968
Ceuthophilus californianus,1,0,1,0.14476460320460613,0.3126936942061339
Ceuthophilus inyo,1,1,2,0.2685730424867646,0.6723203844978234
Chaenactis alpigena,0,15,15,0.14994170356869613,0.21998124924271661
Chaenactis douglasii,4,139,143,6.811102952073812e-06,0.00011724307255000253
Chaenactis fremontii,0,1,1,1.0,1.0
Chaenactis glabriuscula,1,3,4,0.4650164385481151,1.0
Chaenactis nevadensis,0,3,3,1.0,1.0
Chaenactis santolinoides,4,8,12,0.08293252313214843,0.1480937371178578
Chaenactis xantiana,6,5,11,0.002201136146005925,0.0008124952796229928
Chaenomeles speciosa,2,0,2,0.0209561639230412,0.01499159650771353
Chaetopappa ericoides,1,10,11,1.0,0.9368824658167821
Chaetothiersia eguttulata,0,3,3,1.0,1.0
Chaetothiersia vernalis,0,3,3,1.0,1.0
Chaetura vauxi,0,2,2,1.0,1.0
Chaitophorus populicola,1,3,4,0.4650164385481151,1.0
Chalciporus piperatus,2,3,5,0.15522343689242213,0.32387652224382535
Chalcoela iphitalis,0,2,2,1.0,1.0
Chalcophora angulicollis,19,103,122,0.6997722943320823,0.8290875237490019
Chalcophora virginiensis,0,1,1,1.0,1.0
Chalcosyrphus piger,1,2,3,0.3744588472376553,0.9141432822130974
Chamaea fasciata,9,3,12,4.040097077097204e-06,2.881081634006637e-08
Chamaebatia foliolosa,384,1058,1442,1.9938722242070844e-33,2.3211301192281436e-39
Chamaebatiaria millefolium,7,100,107,0.018492258703084657,0.028107896541329787
Chamaenerion angustifolium,21,1210,1231,2.126196017948554e-55,3.867240944051329e-37
Chamaenerion latifolium,0,7,7,0.6034645370398923,0.5813304975648097
Charadrius semipalmatus,0,1,1,1.0,1.0
Charadrius vociferus,1,13,14,0.7079821656760785,0.6890993041903317
Charidotella sexpunctata,1,0,1,0.14476460320460613,0.3126936942061339
Charina bottae,8,264,272,3.8191141685815327e-10,1.0135149819260379e-07
Chenopodiastrum simplex,0,1,1,1.0,1.0
Chenopodium album,0,5,5,1.0,0.7760428250025136
Chenopodium atrovirens,0,1,1,1.0,1.0
Chenopodium fremontii,1,4,5,0.5424646889787644,1.0
Chilocorus stigma,0,1,1,1.0,1.0
Chimaphila menziesii,10,245,255,5.6464136080111766e-08,2.5485474792470526e-06
Chimaphila umbellata,14,179,193,0.0028491773271609594,0.00594662811408623
Chimarocephala pacifica,1,4,5,0.5424646889787644,1.0
Chinavia hilaris,2,1,3,0.056801432979852025,0.0803492820202322
Chionodes mediofuscella,0,1,1,1.0,1.0
Chlamydomonas nivalis,0,12,12,0.2360424886052977,0.31009055076592434
Chlorochroa kanei,0,1,1,1.0,1.0
Chlorochroa ligata,2,0,2,0.0209561639230412,0.01499159650771353
Chlorochroa sayi,1,4,5,0.5424646889787644,1.0
Chlorociboria aeruginascens,1,0,1,0.14476460320460613,0.3126936942061339
Chlorociboria aeruginosa,0,1,1,1.0,1.0
Chlorogalum pomeridianum,88,140,228,3.2203377608606483e-19,1.0392629363417918e-24
Chloroscypha alutipes,2,5,7,0.2688137426846044,0.6011437582684053
Chlorosea banksaria,0,6,6,0.6025804396089913,0.6688993551184468
Chlorosea margaretaria,0,15,15,0.14994170356869613,0.21998124924271661
Chlosyne acastus,0,1,1,1.0,1.0
Chlosyne hoffmanni,0,193,193,1.269027174612981e-13,1.952877295723229e-08
Chlosyne palla,33,165,198,0.36388285090190886,0.4381742913102279
Chondestes grammacus,1,4,5,0.5424646889787644,1.0
Chondrilla juncea,11,2,13,3.4286171116249e-08,1.0962914032288149e-11
Chondrostereum purpureum,0,2,2,1.0,1.0
Chordeiles minor,0,17,17,0.15747128520432685,0.17645428752866515
Choreutis diana,0,1,1,1.0,1.0
Chorispora tenella,0,5,5,1.0,0.7760428250025136
Choristoneura lambertiana,0,1,1,1.0,1.0
Choristoneura retiniana,0,1,1,1.0,1.0
Choristostigma elegantalis,0,3,3,1.0,1.0
Choristostigma zephyralis,0,5,5,1.0,0.7760428250025136
Chorizanthe brevicornu,0,3,3,1.0,1.0
Chorizanthe membranacea,2,2,4,0.10278607328810296,0.1906437976216683
Chorizanthe watsonii,0,7,7,0.6034645370398923,0.5813304975648097
Chorizanthe xanti,1,0,1,0.14476460320460613,0.3126936942061339
Chromosera cyanophylla,0,17,17,0.15747128520432685,0.17645428752866515
Chroogomphus albipes,1,5,6,1.0,1.0
Chroogomphus loculatus,2,1,3,0.056801432979852025,0.0803492820202322
Chroogomphus ochraceus,11,7,18,6.8896460561375466e-06,1.2342894153835435e-07
Chroogomphus vinicolor,3,9,12,0.3994183286503844,0.5314104390489738
Chrysobothris cyanella,1,1,2,0.2685730424867646,0.6723203844978234
Chrysobothris subcylindrica,1,0,1,0.14476460320460613,0.3126936942061339
Chrysobothris viridicyanea,0,2,2,1.0,1.0
Chrysochus cobaltinus,3,40,43,0.19643775428263743,0.23756367230426415
Chrysolepis sempervirens,12,648,660,2.2023208328423374e-29,3.506759644719532e-20
Chrysolina hyperici,8,2,10,6.5864666725043825e-06,5.342167245405184e-08
Chrysolina quadrigemina,0,1,1,1.0,1.0
Chrysomela aeneicollis,0,2,2,1.0,1.0
Chrysomphalina aurantiaca,0,17,17,0.15747128520432685,0.17645428752866515
Chrysomphalina chrysophylla,2,2,4,0.10278607328810296,0.1906437976216683
Chrysomyxa arctostaphyli,0,1,1,1.0,1.0
Chrysomyxa ledi,0,1,1,1.0,1.0
Chrysopa coloradensis,2,5,7,0.2688137426846044,0.6011437582684053
Chrysopa nigricornis,0,1,1,1.0,1.0
Chrysopa quadripunctata,1,1,2,0.2685730424867646,0.6723203844978234
Chrysopa timberlakei,0,2,2,1.0,1.0
Chrysophana placida,0,9,9,0.37460992252836506,0.4468858706621094
Chrysopilus tomentosus,1,0,1,0.14476460320460613,0.3126936942061339
Chrysops coloradensis,0,1,1,1.0,1.0
Chrysops furcatus,0,1,1,1.0,1.0
Chrysoteuchia topiarius,0,4,4,1.0,0.9105509465652237
Chrysothamnus viscidiflorus,6,64,70,0.23140033534271734,0.21702659564698204
Chylismia claviformis,0,2,2,1.0,1.0
Chylismiella pterosperma,0,8,8,0.6124215574698968,0.5084255632839996
Chyliza leguminicola,0,1,1,1.0,1.0
Ciboria rufofusca,0,7,7,0.6034645370398923,0.5813304975648097
Cichorium intybus,12,27,39,0.00954348997983995,0.007712128471749944
Cicindela depressula,0,7,7,0.6034645370398923,0.5813304975648097
Cicindela longilabris,0,47,47,0.0012664264058445166,0.008959167191137872
Cicindela nebraskana,0,1,1,1.0,1.0
Cicindela oregona,1,63,64,0.0010324574951009714,0.005798708376138559
Cicindela purpurea,0,12,12,0.2360424886052977,0.31009055076592434
Cicindela tenuicincta,0,1,1,1.0,1.0
Cicindela tranquebarica,0,44,44,0.0019256532943994855,0.011899006497493885
Cicuta douglasii,0,2,2,1.0,1.0
Cinara curvipes,0,1,1,1.0,1.0
Cinclus mexicanus,15,137,152,0.13248634117598299,0.1336366044317401
Cinna bolanderi,2,11,13,1.0,1.0
Cinna latifolia,0,1,1,1.0,1.0
Cipangopaludina chinensis,2,0,2,0.0209561639230412,0.01499159650771353
Circaea alpina,3,62,65,0.0205927882472191,0.037200170744672585
Circotettix maculatus,0,9,9,0.37460992252836506,0.4468858706621094
Circotettix shastanus,0,2,2,1.0,1.0
Circotettix undulatus,0,4,4,1.0,0.9105509465652237
Circus cyaneus,0,4,4,1.0,0.9105509465652237
Cirsium andersonii,2,622,624,4.0097810420769664e-39,1.3954405555040775e-23
Cirsium arizonicum,1,6,7,1.0,1.0
Cirsium arvense,0,2,2,1.0,1.0
Cirsium congdonii,0,1,1,1.0,1.0
Cirsium cymosum,0,1,1,1.0,1.0
Cirsium douglasii,0,1,1,1.0,1.0
Cirsium occidentale,23,49,72,0.00014907708142495346,5.216205505822568e-05
Cirsium scariosum,1,120,121,1.992502937227454e-07,3.4825943246813596e-05
Cirsium tioganum,0,12,12,0.2360424886052977,0.31009055076592434
Cirsium vulgare,37,174,211,0.20344860565511097,0.2437493309889291
Cistothorus palustris,0,2,2,1.0,1.0
Cistus creticus,0,2,2,1.0,1.0
Cistus purpureus,0,1,1,1.0,1.0
Cixidia fusiformis,0,2,2,1.0,1.0
Cixidia henshawi,1,0,1,0.14476460320460613,0.3126936942061339
Claassenia sabulosa,1,2,3,0.3744588472376553,0.9141432822130974
Cladara limitaria,1,0,1,0.14476460320460613,0.3126936942061339
Cladonia carneola,0,1,1,1.0,1.0
Cladonia coniocraea,0,1,1,1.0,1.0
Cladonia macilenta,2,1,3,0.056801432979852025,0.0803492820202322
Clarkia amoena,1,0,1,0.14476460320460613,0.3126936942061339
Clarkia arcuata,1,2,3,0.3744588472376553,0.9141432822130974
Clarkia biloba,39,2,41,1.0915289621648028e-30,2.322937605048621e-47
Clarkia concinna,9,1,10,2.4259786172080083e-07,2.3235216610518305e-10
Clarkia cylindrica,0,3,3,1.0,1.0
Clarkia dudleyana,14,13,27,5.434053754178943e-06,1.5517767991261642e-07
Clarkia gracilis,3,3,6,0.0431068667335647,0.05837521372070738
Clarkia heterandra,5,0,5,6.355973818199171e-05,1.5903757301150513e-06
Clarkia lassenensis,0,1,1,1.0,1.0
Clarkia lingulata,1,2,3,0.3744588472376553,0.9141432822130974
Clarkia mildrediae,3,24,27,0.7886865336637121,0.8231296973634802
Clarkia mosquinii,2,2,4,0.10278607328810296,0.1906437976216683
Clarkia purpurea,17,6,23,2.244976918590303e-10,5.938421588892379e-15
Clarkia rhomboidea,52,207,259,0.013158242978380606,0.013323882387868517
Clarkia speciosa,2,0,2,0.0209561639230412,0.01499159650771353
Clarkia springvillensis,1,6,7,1.0,1.0
Clarkia stellata,2,13,15,1.0,1.0
Clarkia unguiculata,19,7,26,2.6274937955555477e-11,2.140634252978971e-16
Clarkia virgata,0,7,7,0.6034645370398923,0.5813304975648097
Clarkia williamsonii,23,58,81,0.0012362083790629147,0.0006666900731707415
Clarkia xantiana,5,6,11,0.013693210356916412,0.012717642011991449
Clastoptera brunnea,0,1,1,1.0,1.0
Clathrus ruber,1,1,2,0.2685730424867646,0.6723203844978234
Clavaria fragilis,2,3,5,0.15522343689242213,0.32387652224382535
Clavariadelphus mucronatus,0,1,1,1.0,1.0
Clavariadelphus occidentalis,3,1,4,0.010816792675262966,0.00633924523846032
Clavariadelphus pallidoincarnatus,0,1,1,1.0,1.0
Clavicorona taxophila,1,1,2,0.2685730424867646,0.6723203844978234
Clavulina rugosa,0,1,1,1.0,1.0
Clavulinopsis laeticolor,0,1,1,1.0,1.0
Claytonia crawfordii,0,3,3,1.0,1.0
Claytonia exigua,3,0,3,0.0030335293929702875,0.000700171082788584
Claytonia lanceolata,0,92,92,8.468760068601877e-07,0.00014530276248556968
Claytonia megarhiza,0,8,8,0.6124215574698968,0.5084255632839996
Claytonia nevadensis,0,4,4,1.0,0.9105509465652237
Claytonia palustris,0,4,4,1.0,0.9105509465652237
Claytonia parviflora,44,61,105,8.606701500024221e-12,4.125053742588068e-15
Claytonia perfoliata,52,72,124,1.1245727870702689e-13,1.079635922276011e-17
Claytonia rubra,16,106,122,0.7966907538322134,0.7650206717931042
Claytonia sibirica,0,1,1,1.0,1.0
Claytonia umbellata,0,1,1,1.0,1.0
Clematis lasiantha,3,0,3,0.0030335293929702875,0.000700171082788584
Clematis ligusticifolia,4,0,4,0.00043910829886184923,3.314336839661014e-05
Cleomella arborea,0,1,1,1.0,1.0
Cleomella brevipes,1,0,1,0.14476460320460613,0.3126936942061339
Cleomella lutea,0,2,2,1.0,1.0
Cleomella obtusifolia,0,1,1,1.0,1.0
Cleomella serrulata,0,1,1,1.0,1.0
Clepsis peritana,1,0,1,0.14476460320460613,0.3126936942061339
Clepsis persicana,0,3,3,1.0,1.0
Clidophleps vagans,1,0,1,0.14476460320460613,0.3126936942061339
Climaciella brunnea,1,0,1,0.14476460320460613,0.3126936942061339
Clinopleura infuscata,2,0,2,0.0209561639230412,0.01499159650771353
Clintonia uniflora,0,108,108,6.605745005514061e-08,3.472663377260585e-05
Clitocybe albirhiza,0,12,12,0.2360424886052977,0.31009055076592434
Clitocybe fragrans,7,4,11,0.00025616982714586243,2.60591529641861e-05
Clitocybe glacialis,0,72,72,2.7335748278066125e-05,0.0008868002234403889
Clitocybe odora,0,2,2,1.0,1.0
Clitocybula lacerata,0,1,1,1.0,1.0
Clitopilus aureicystidiatus,0,1,1,1.0,1.0
Clitopilus baronii,0,1,1,1.0,1.0
Clogmia albipunctatus,2,0,2,0.0209561639230412,0.01499159650771353
Clostera apicalis,0,1,1,1.0,1.0
Clostera brucei,0,1,1,1.0,1.0
Closterotomus norvegicus,1,2,3,0.3744588472376553,0.9141432822130974
Clostoeca disjuncta,0,5,5,1.0,0.7760428250025136
Clytus clitellarius,0,3,3,1.0,1.0
Clytus planifrons,0,13,13,0.23752623411074927,0.27601031745794824
Coccinella alta,0,1,1,1.0,1.0
Coccinella monticola,0,1,1,1.0,1.0
Coccinella novemnotata,0,2,2,1.0,1.0
Coccinella septempunctata,4,35,39,0.6479699818657503,0.6020198195370186
Coccinella transversoguttata,0,2,2,1.0,1.0
Coccinella trifasciata,0,6,6,0.6025804396089913,0.6688993551184468
Coccomyces dentatus,1,0,1,0.14476460320460613,0.3126936942061339
Coccyzus americanus,0,2,2,1.0,1.0
Cochlorhinus stygicus,0,1,1,1.0,1.0
Coelocnemis dilaticollis,2,37,39,0.1118864379662942,0.15221242247359804
Coelocnemis magna,0,1,1,1.0,1.0
Coenagrion resolutum,0,2,2,1.0,1.0
Coenonympha california,32,29,61,3.7582761151371404e-12,1.5805794796795436e-16
Colaptes auratus,57,206,263,0.001532375228699348,0.001231885548317816
Coleocentrus occidentalis,0,1,1,1.0,1.0
Coleogyne ramosissima,1,1,2,0.2685730424867646,0.6723203844978234
Coleonyx variegatus,1,0,1,0.14476460320460613,0.3126936942061339
Coleophora glaucella,2,0,2,0.0209561639230412,0.01499159650771353
Colias behrii,0,50,50,0.0008358351626706249,0.006757170935664538
Colias eurytheme,11,107,118,0.11742401193880848,0.14404163166293557
Colladonus montanus,0,5,5,1.0,0.7760428250025136
Collema nigrescens,1,0,1,0.14476460320460613,0.3126936942061339
Collinsia callosa,1,2,3,0.3744588472376553,0.9141432822130974
Collinsia childii,8,12,20,0.004741703787194284,0.003428996841163759
Collinsia heterophylla,17,2,19,6.837467375909199e-13,3.0994432574330224e-19
Collinsia parviflora,0,50,50,0.0008358351626706249,0.006757170935664538
Collinsia sparsiflora,1,1,2,0.2685730424867646,0.6723203844978234
Collinsia tinctoria,77,56,133,5.664617411136133e-31,3.19589052349965e-45
Collinsia torreyi,3,234,237,1.6033452359366518e-12,1.2625550874162182e-08
Collinsia wrightii,0,9,9,0.37460992252836506,0.4468858706621094
Collomia grandiflora,77,552,629,0.11229369358480233,0.12387721302240633
Collomia heterophylla,55,102,157,1.3131561148932298e-10,5.624311188442974e-13
Collomia linearis,0,30,30,0.016694385851981373,0.04613372038512279
Collomia rawsoniana,2,7,9,0.6270956953788205,0.8518628753529384
Collomia tinctoria,0,34,34,0.011544912843706439,0.03112496262794068
Collops bipunctatus,0,2,2,1.0,1.0
Collybia bakerensis,0,5,5,1.0,0.7760428250025136
Collybia cirrhata,2,0,2,0.0209561639230412,0.01499159650771353
Collybiopsis quercophila,8,0,8,1.9272389244988723e-07,1.8600410733089334e-10
Collybiopsis villosipes,1,0,1,0.14476460320460613,0.3126936942061339
Colonus hesperus,47,17,64,3.553065288897744e-26,5.892102426090306e-40
Coloradia pandora,0,81,81,4.667851558254971e-06,0.00039165750644915075
Coltricia confluens,1,1,2,0.2685730424867646,0.6723203844978234
Coltricia perennis,0,8,8,0.6124215574698968,0.5084255632839996
Coluber constrictor,2,39,41,0.11530043436325724,0.12727654269489433
Columba livia,0,4,4,1.0,0.9105509465652237
Colutea arborescens,2,0,2,0.0209561639230412,0.01499159650771353
Comandra umbellata,6,13,19,0.04622915715125239,0.07301310260852441
Comarum palustre,0,10,10,0.3757244358299004,0.39438447212016514
Comastoma tenellum,0,2,2,1.0,1.0
Comatricha fusiformis,0,3,3,1.0,1.0
Comatricha nigra,0,1,1,1.0,1.0
Condica discistriga,1,0,1,0.14476460320460613,0.3126936942061339
Condylostylus occidentalis,0,2,2,1.0,1.0
Conium maculatum,3,1,4,0.010816792675262966,0.00633924523846032
Conocybe semiglobata,0,1,1,1.0,1.0
Conocybe tenera,1,1,2,0.2685730424867646,0.6723203844978234
Contia tenuis,27,42,69,4.5305698442980657e-07,1.6034398123217354e-08
Contopus cooperi,8,50,58,1.0,1.0
Contopus sordidulus,28,242,270,0.05665174256233896,0.06691024707496322
Contumyces rosellus,2,0,2,0.0209561639230412,0.01499159650771353
Convolvulus arvensis,4,22,26,0.783753333771702,1.0
Copanarta sexpunctata,0,2,2,1.0,1.0
Coprinellus bipellis,2,12,14,1.0,1.0
Coprinellus disseminatus,1,0,1,0.14476460320460613,0.3126936942061339
Coprinellus micaceus,5,3,8,0.0024244129099057063,0.0007850786162003298
Coprinopsis atramentaria,0,2,2,1.0,1.0
Coprinopsis jonesii,0,1,1,1.0,1.0
Coprinopsis lagopus,22,7,29,1.8731590766190935e-13,6.744300558435117e-20
Coprinus calyptratus,0,2,2,1.0,1.0
Coprinus comatus,15,61,76,0.19205540489586093,0.25406321359324635
Coprinus sterquilinus,1,0,1,0.14476460320460613,0.3126936942061339
Coptodisca arbutiella,0,1,1,1.0,1.0
Coptotomus longulus,0,1,1,1.0,1.0
Corallorhiza maculata,18,554,572,2.2480874617837954e-19,1.970793779305927e-14
Corallorhiza striata,3,126,129,7.071077614539262e-06,0.00014568240996790203
Corbicula fluminea,1,13,14,0.7079821656760785,0.6890993041903317
Cordulegaster dorsalis,18,53,71,0.01649215316143028,0.014841988382455616
Cordulia shurtleffii,0,34,34,0.011544912843706439,0.03112496262794068
Cordylanthus eremicus,0,3,3,1.0,1.0
Cordylanthus kingii,2,36,38,0.16129779019077917,0.16644259216844146
Cordylanthus pilosus,2,0,2,0.0209561639230412,0.01499159650771353
Cordylanthus ramosus,0,1,1,1.0,1.0
Cordylanthus rigidus,5,4,9,0.004804892843884087,0.0024551155675152643
Cordylanthus tenuis,1,21,22,0.3559263140695814,0.3072913058315549
Coreopsis bigelovii,5,2,7,0.0010327341762908842,0.00018014051424031924
Corethrogyne filaginifolia,8,5,13,0.00012493599837919194,9.489826548441195e-06
Cornu aspersum,4,0,4,0.00043910829886184923,3.314336839661014e-05
Cornus glabrata,1,1,2,0.2685730424867646,0.6723203844978234
Cornus nuttallii,138,1009,1147,0.01835328246551482,0.02043845771798816
Cornus sericea,12,158,170,0.004321212220348976,0.008271591163642901
Cornus sessilis,11,26,37,0.016208161646916797,0.016239436790634682
Cornus torreyi,2,2,4,0.10278607328810296,0.1906437976216683
Coronilla varia,0,12,12,0.2360424886052977,0.31009055076592434
Cortinarius acutispissipes,0,2,2,1.0,1.0
Cortinarius atroalbus,0,1,1,1.0,1.0
Cortinarius bridgei,0,2,2,1.0,1.0
Cortinarius brunneovernus,1,0,1,0.14476460320460613,0.3126936942061339
Cortinarius caperatus,0,6,6,0.6025804396089913,0.6688993551184468
Cortinarius cinnamomeoluteus,0,1,1,1.0,1.0
Cortinarius cisqhale,5,0,5,6.355973818199171e-05,1.5903757301150513e-06
Cortinarius cistopulchripes,0,1,1,1.0,1.0
Cortinarius clandestinus,0,1,1,1.0,1.0
Cortinarius comptulus,4,3,7,0.0106471288054473,0.007559096939159896
Cortinarius croceus,1,7,8,1.0,1.0
Cortinarius desertorum,0,2,2,1.0,1.0
Cortinarius distortus,1,0,1,0.14476460320460613,0.3126936942061339
Cortinarius eldoradoensis,0,4,4,1.0,0.9105509465652237
Cortinarius fragrantissimus,0,2,2,1.0,1.0
Cortinarius fructuodorus,0,1,1,1.0,1.0
Cortinarius fuscoflexipes,0,1,1,1.0,1.0
Cortinarius fuscotomentosus,2,0,2,0.0209561639230412,0.01499159650771353
Cortinarius glutinosoarmillatus,9,0,9,2.7892926019110602e-08,9.215270667313031e-12
Cortinarius helodes,0,1,1,1.0,1.0
Cortinarius hemitrichus,0,1,1,1.0,1.0
Cortinarius immixtus,0,1,1,1.0,1.0
Cortinarius infractus,1,0,1,0.14476460320460613,0.3126936942061339
Cortinarius iunii,0,1,1,1.0,1.0
Cortinarius laniger,1,0,1,0.14476460320460613,0.3126936942061339
Cortinarius leiocastaneus,0,1,1,1.0,1.0
Cortinarius magnivelatus,0,14,14,0.24486350799097997,0.24618548812479032
Cortinarius miwok,0,1,1,1.0,1.0
Cortinarius niveotraganus,0,1,1,1.0,1.0
Cortinarius ohlone,1,0,1,0.14476460320460613,0.3126936942061339
Cortinarius pansa,0,3,3,1.0,1.0
Cortinarius pinguis,0,8,8,0.6124215574698968,0.5084255632839996
Cortinarius roseomyceliosus,0,1,1,1.0,1.0
Cortinarius salor,1,0,1,0.14476460320460613,0.3126936942061339
Cortinarius sierraensis,0,1,1,1.0,1.0
Cortinarius smithii,1,0,1,0.14476460320460613,0.3126936942061339
Cortinarius subbalaustinus,0,1,1,1.0,1.0
Cortinarius thiersii,0,11,11,0.38449278358904854,0.3492157200022511
Cortinarius truckeensis,0,3,3,1.0,1.0
Cortinarius tuolumnensis,0,1,1,1.0,1.0
Cortinarius uraceus,0,2,2,1.0,1.0
Cortinarius velatus,0,1,1,1.0,1.0
Cortinarius violaceus,4,7,11,0.06219290144309395,0.10212099408086615
Corvus brachyrhynchos,2,12,14,1.0,1.0
Corvus corax,44,474,518,4.516556814975648e-05,0.00013780812204973334
Corydalis caseana,0,6,6,0.6025804396089913,0.6688993551184468
Corydalus texanus,1,0,1,0.14476460320460613,0.3126936942061339
Corylus americana,0,1,1,1.0,1.0
Corylus cornuta,32,141,173,0.13085047044776885,0.16285720726829628
Corynorhinus townsendii,1,8,9,1.0,1.0
Cosmia calami,0,1,1,1.0,1.0
Cosmia praeacuta,0,3,3,1.0,1.0
Cosmopepla conspicillaris,3,26,29,0.7908280788933808,0.7125101212946094
Cosmopepla intergressus,1,4,5,0.5424646889787644,1.0
Cosmopepla lintneriana,0,1,1,1.0,1.0
Cosmopepla uhleri,2,13,15,1.0,1.0
Cosmos bipinnatus,0,1,1,1.0,1.0
Cosmosalia chrysocoma,0,130,130,2.192392455233734e-09,4.928378200822232e-06
Cotinis mutabilis,0,1,1,1.0,1.0
Cottus beldingii,0,30,30,0.016694385851981373,0.04613372038512279
Crabro latipes,0,1,1,1.0,1.0
Crambus gausapalis,0,3,3,1.0,1.0
Crambus perlellus,0,1,1,1.0,1.0
Crassisporium funariophilum,0,29,29,0.016473723171988544,0.05095618599691111
Crassula tillaea,1,0,1,0.14476460320460613,0.3126936942061339
Crataegus monogyna,13,0,13,1.2234839517425721e-11,5.772854719912279e-17
Craterellus calicornucopioides,4,0,4,0.00043910829886184923,3.314336839661014e-05
Cratoneuron filicinum,0,1,1,1.0,1.0
Cratypedes lateritius,0,5,5,1.0,0.7760428250025136
Cratypedes neglectus,0,12,12,0.2360424886052977,0.31009055076592434
Crepidotus epibryus,0,2,2,1.0,1.0
Crepidotus fimbriatus,0,3,3,1.0,1.0
Crepidotus mollis,3,1,4,0.010816792675262966,0.00633924523846032
Crepidotus variabilis,1,0,1,0.14476460320460613,0.3126936942061339
Crepis acuminata,0,17,17,0.15747128520432685,0.17645428752866515
Crepis intermedia,0,2,2,1.0,1.0
Crepis occidentalis,0,14,14,0.24486350799097997,0.24618548812479032
Crepis runcinata,0,1,1,1.0,1.0
Cribraria rufa,0,1,1,1.0,1.0
Criorhina coquilletti,0,1,1,1.0,1.0
Criorhina fusca,0,1,1,1.0,1.0
Crocidema californica,0,1,1,1.0,1.0
Cronartium coleosporioides,0,1,1,1.0,1.0
Cronartium harknessii,6,12,18,0.035903562045316396,0.05251993186095004
Cronartium ribicola,0,3,3,1.0,1.0
Crossidius hirtipes,0,1,1,1.0,1.0
Crotalus cerastes,1,2,3,0.3744588472376553,0.9141432822130974
Crotalus oreganus,93,217,310,3.4657585741640447e-12,1.4359010899348833e-14
Crotalus scutulatus,1,0,1,0.14476460320460613,0.3126936942061339
Crotalus stephensi,2,2,4,0.10278607328810296,0.1906437976216683
Crotaphytus bicinctores,1,3,4,0.4650164385481151,1.0
Croton setiger,21,16,37,2.8261000951595376e-09,1.4819681227240155e-12
Crucianella angustifolia,2,0,2,0.0209561639230412,0.01499159650771353
Crucibulum laeve,18,15,33,8.887321107348678e-08,3.0765445453321615e-10
Crumia latifolia,2,0,2,0.0209561639230412,0.01499159650771353
Crustulina sticta,1,0,1,0.14476460320460613,0.3126936942061339
Cryptantha affinis,0,3,3,1.0,1.0
Cryptantha echinella,0,1,1,1.0,1.0
Cryptantha gracilis,2,15,17,1.0,1.0
Cryptantha incana,0,1,1,1.0,1.0
Cryptantha nevadensis,2,1,3,0.056801432979852025,0.0803492820202322
Cryptantha pterocarya,0,2,2,1.0,1.0
Cryptantha scoparia,0,1,1,1.0,1.0
Cryptantha simulans,0,1,1,1.0,1.0
Cryptantha utahensis,0,1,1,1.0,1.0
Cryptocephalus sanguinicollis,0,1,1,1.0,1.0
Cryptogramma acrostichoides,1,120,121,1.992502937227454e-07,3.4825943246813596e-05
Cryptoporus volvatus,55,910,965,6.4029043909527975e-18,1.1457757000957891e-14
Ctenucha rubroscapus,4,16,20,0.519112689646881,0.7007507078681314
Cucujus clavipes,3,18,21,1.0,1.0
Cucullia antipoda,0,1,1,1.0,1.0
Cucullia dorsalis,0,1,1,1.0,1.0
Cucullia intermedia,1,0,1,0.14476460320460613,0.3126936942061339
Cucurbita foetidissima,2,0,2,0.0209561639230412,0.01499159650771353
Culiseta incidens,0,1,1,1.0,1.0
Cuniculotinus gramineus,0,6,6,0.6025804396089913,0.6688993551184468
Cuphophyllus cinerellus,0,3,3,1.0,1.0
Cuphophyllus pratensis,1,0,1,0.14476460320460613,0.3126936942061339
Cuphophyllus russocoriaceus,2,1,3,0.056801432979852025,0.0803492820202322
Cuphophyllus virgineus,1,1,2,0.2685730424867646,0.6723203844978234
Cupressus arizonica,7,0,7,1.3315701680073362e-06,3.775277184632102e-09
Cupressus macnabiana,13,0,13,1.2234839517425721e-11,5.772854719912279e-17
Cuscuta californica,0,12,12,0.2360424886052977,0.31009055076592434
Cuscuta subinclusa,1,0,1,0.14476460320460613,0.3126936942061339
Cusickiella douglasii,0,1,1,1.0,1.0
Cusickiella quadricostata,0,8,8,0.6124215574698968,0.5084255632839996
Cuterebra tenebriformis,0,1,1,1.0,1.0
Cyanocitta stelleri,179,1223,1402,0.07330251830471196,0.0739369801720839
Cyanosporus caesius,4,1,5,0.0019413025415773043,0.00041787713651955216
Cyathicula cyathoidea,0,1,1,1.0,1.0
Cycladenia humilis,0,1,1,1.0,1.0
Cyclamen hederifolium,0,1,1,1.0,1.0
Cycloneda polita,14,37,51,0.014973061670883093,0.014906375395703319
Cyclophora dataria,1,5,6,1.0,1.0
Cyclophora nanaria,0,1,1,1.0,1.0
Cyclosa conica,4,9,13,0.10658251785953915,0.20215021085988086
Cydia pomonella,0,2,2,1.0,1.0
Cygnus columbianus,0,2,2,1.0,1.0
Cygnus cygnus,1,0,1,0.14476460320460613,0.3126936942061339
Cygnus olor,0,1,1,1.0,1.0
Cylindromyia intermedia,0,1,1,1.0,1.0
Cylindropuntia echinocarpa,1,1,2,0.2685730424867646,0.6723203844978234
Cylisticus convexus,2,0,2,0.0209561639230412,0.01499159650771353
Cymopterus globosus,0,1,1,1.0,1.0
Cynoglossum officinale,0,2,2,1.0,1.0
Cynosurus echinatus,29,31,60,4.91187882661795e-10,3.569683469342589e-13
Cyperus eragrostis,5,2,7,0.0010327341762908842,0.00018014051424031924
Cyperus squarrosus,0,1,1,1.0,1.0
Cyphon concinnus,1,3,4,0.4650164385481151,1.0
Cyprinus carpio,1,0,1,0.14476460320460613,0.3126936942061339
Cyprinus rubrofuscus,0,1,1,1.0,1.0
Cypripedium fasciculatum,4,22,26,0.783753333771702,1.0
Cypripedium montanum,1,21,22,0.3559263140695814,0.3072913058315549
Cypseloides niger,4,1,5,0.0019413025415773043,0.00041787713651955216
Cyrtophyllicus chlorum,2,3,5,0.15522343689242213,0.32387652224382535
Cyrtopogon callipedilus,0,1,1,1.0,1.0
Cystiphora schmidti,0,1,1,1.0,1.0
Cystoderma amianthinum,0,1,1,1.0,1.0
Cystoderma fallax,7,6,13,0.0010192335799894875,0.0002724004392891465
Cystodermella cinnabarina,0,2,2,1.0,1.0
Cystodermella granulosa,0,1,1,1.0,1.0
Cystofilobasidium macerans,0,1,1,1.0,1.0
Cystopteris fragilis,14,87,101,1.0,0.9726458539984584
Cytisus scoparius,88,19,107,3.5723378427002624e-55,3.6310004834163825e-87
Dacerla mediospinosa,0,3,3,1.0,1.0
Dacrymyces capitatus,0,2,2,1.0,1.0
Dacrymyces chrysospermus,7,8,15,0.002928859390410695,0.0014910704758996124
Dacrymyces stillatus,1,2,3,0.3744588472376553,0.9141432822130974
Dactylis glomerata,12,53,65,0.3759891321982967,0.461140905830667
Dalea searlsiae,0,3,3,1.0,1.0
Daleomyces phillipsii,0,1,1,1.0,1.0
Danaus gilippus,0,1,1,1.0,1.0
Danaus plexippus,17,93,110,0.7858940573087657,0.8759570585553695
Danosoma brevicorne,0,4,4,1.0,0.9105509465652237
Danthonia californica,1,4,5,0.5424646889787644,1.0
Danthonia unispicata,0,5,5,1.0,0.7760428250025136
Dargida procinctus,0,4,4,1.0,0.9105509465652237
Darlingtonia californica,0,19,19,0.09746384240092232,0.14226189947649115
Darmera peltata,75,262,337,0.00013259243006868992,6.766690488454385e-05
Dasineura lupinorum,2,0,2,0.0209561639230412,0.01499159650771353
Dasineura salicifoliae,0,3,3,1.0,1.0
Dasineura silvestrii,1,4,5,0.5424646889787644,1.0
Dasiphora fruticosa,0,95,95,5.530142557160707e-07,0.00011100260986042169
Dasyfidonia avuncularia,0,21,21,0.06152025756350138,0.11517086832716916
Dasypyga alternosquamella,0,11,11,0.38449278358904854,0.3492157200022511
Dasysyrphus creper,0,1,1,1.0,1.0
Datisca glomerata,4,6,10,0.044556650138771095,0.06510377152388026
Datura stramonium,1,0,1,0.14476460320460613,0.3126936942061339
Datura wrightii,6,4,10,0.0011402454266372147,0.00027048935008859744
Daucus carota,18,10,28,2.3395307090729896e-09,5.102559644735591e-13
Daucus pusillus,3,0,3,0.0030335293929702875,0.000700171082788584
Decantha stonda,0,16,16,0.15161267346782015,0.19687992504129675
Deconica coprophila,0,1,1,1.0,1.0
Deconica montana,0,8,8,0.6124215574698968,0.5084255632839996
Decticita yosemite,1,4,5,0.5424646889787644,1.0
Dedeckera eurekensis,1,0,1,0.14476460320460613,0.3126936942061339
Deinandra mohavensis,1,1,2,0.2685730424867646,0.6723203844978234
Delphinium andersonii,2,8,10,0.6456440117183423,0.9624710515030661
Delphinium glaucum,0,70,70,2.5806452682206875e-05,0.0010643241617196923
Delphinium gracilentum,2,0,2,0.0209561639230412,0.01499159650771353
Delphinium hansenii,1,0,1,0.14476460320460613,0.3126936942061339
Delphinium hesperium,1,0,1,0.14476460320460613,0.3126936942061339
Delphinium nudicaule,1,17,18,0.5002083905620196,0.4588452058316618
Delphinium nuttallianum,1,18,19,0.5081076590495464,0.41485136099373987
Delphinium parishii,0,9,9,0.37460992252836506,0.4468858706621094
Delphinium patens,3,1,4,0.010816792675262966,0.00633924523846032
Delphinium polycladon,0,2,2,1.0,1.0
Delphinium purpusii,0,1,1,1.0,1.0
Dendragapus fuliginosus,6,415,421,6.910991448748501e-21,4.372277752656478e-14
Dendraster excentricus,1,0,1,0.14476460320460613,0.3126936942061339
Dendroalsia abietina,67,33,100,1.0127489605035627e-32,1.7276318362036044e-49
Dendrocollybia racemosa,4,4,8,0.01886984470142184,0.01861366248431812
Dendroctonus ponderosae,0,4,4,1.0,0.9105509465652237
Dendroctonus valens,0,2,2,1.0,1.0
Dendroides picipes,0,1,1,1.0,1.0
Dendroleon speciosus,0,7,7,0.6034645370398923,0.5813304975648097
Dendromecon rigida,54,20,74,1.2552181730131551e-29,2.1949648033328094e-45
Dendrostilbella smaragdina,0,2,2,1.0,1.0
Dendrothele candida,1,1,2,0.2685730424867646,0.6723203844978234
Deretaphrus oregonensis,0,1,1,1.0,1.0
Dermacentor andersoni,0,2,2,1.0,1.0
Dermacentor occidentalis,10,2,12,2.0097456022740384e-07,1.9031792621558245e-10
Dermacentor similis,0,1,1,1.0,1.0
Dermacentor variabilis,1,1,2,0.2685730424867646,0.6723203844978234
Dermatocarpon miniatum,0,1,1,1.0,1.0
Dermatocarpon reticulatum,0,4,4,1.0,0.9105509465652237
Deroceras laeve,0,2,2,1.0,1.0
Deroceras reticulatum,0,2,2,1.0,1.0
Deschampsia cespitosa,0,4,4,1.0,0.9105509465652237
Deschampsia danthonioides,0,1,1,1.0,1.0
Deschampsia elongata,1,4,5,0.5424646889787644,1.0
Descurainia californica,0,1,1,1.0,1.0
Descurainia pinnata,2,4,6,0.21128172197002185,0.4637992200137968
Descurainia sophia,2,2,4,0.10278607328810296,0.1906437976216683
Desmocerus aureipennis,0,12,12,0.2360424886052977,0.31009055076592434
Diabrotica undecimpunctata,3,15,18,0.7373365905564824,1.0
Diacheopsis kowalskii,0,1,1,1.0,1.0
Diadasia bituberculata,2,1,3,0.056801432979852025,0.0803492820202322
Diadasia nigrifrons,1,2,3,0.3744588472376553,0.9141432822130974
Diadophis punctatus,21,20,41,3.273284272853867e-08,1.0119258533674611e-10
Dianema nivale,0,1,1,1.0,1.0
Dianthus armeria,1,7,8,1.0,1.0
Dianthus barbatus,3,2,5,0.02413002787627292,0.023975245305455268
Dianthus deltoides,0,1,1,1.0,1.0
Diaspis manzanitae,0,1,1,1.0,1.0
Diastictis fracturalis,1,0,1,0.14476460320460613,0.3126936942061339
Dicentra formosa,144,345,489,2.0421228209249872e-17,8.257587917982185e-21
Dicentra nevadensis,1,9,10,1.0,1.0
Dicentra pauciflora,1,16,17,0.4959452943950571,0.5076929481255973
Dicentra uniflora,0,153,153,7.542903407581463e-11,6.48902435426559e-07
Dicerca crassicollis,0,2,2,1.0,1.0
Dicerca sexualis,1,1,2,0.2685730424867646,0.6723203844978234
Dichagyris variabilis,1,0,1,0.14476460320460613,0.3126936942061339
Dichanthelium acuminatum,0,1,1,1.0,1.0
Dichanthelium lanuginosum,0,2,2,1.0,1.0
Dichelonyx backii,0,6,6,0.6025804396089913,0.6688993551184468
Dichelostemma congestum,9,2,11,1.1607551894565098e-06,3.2337159071325644e-09
Dichelostemma multiflorum,35,66,101,4.68318465826062e-07,1.8770010821102518e-08
Dichelostemma volubile,80,16,96,3.662513374820081e-51,9.016634082640339e-81
Dichelotarsus cavicollis,2,0,2,0.0209561639230412,0.01499159650771353
Dichorda illustraria,0,1,1,1.0,1.0
Dicosmoecus atripes,0,2,2,1.0,1.0
Dicranoweisia cirrata,0,1,1,1.0,1.0
Dictyoptera simplicipes,5,32,37,1.0,1.0
Didea fuscipes,0,1,1,1.0,1.0
Didelphis virginiana,6,6,12,0.0038645835637426216,0.002020624115740119
Didymosphenia geminatum,0,1,1,1.0,1.0
Dieteria canescens,2,46,48,0.03931717494797546,0.06798299433391557
Digitalis purpurea,44,88,132,6.628819867116332e-08,1.5844773691911528e-09
Digrammia californiaria,0,1,1,1.0,1.0
Digrammia curvata,0,5,5,1.0,0.7760428250025136
Digrammia muscariata,2,0,2,0.0209561639230412,0.01499159650771353
Digrammia neptaria,2,13,15,1.0,1.0
Dimelaena oreina,0,2,2,1.0,1.0
Dinothenarus saphyrinus,0,1,1,1.0,1.0
Dione vanillae,2,4,6,0.21128172197002185,0.4637992200137968
Dioryctria auranticella,0,1,1,1.0,1.0
Dioryctria hodgesi,0,1,1,1.0,1.0
Dioryctria westerlandi,0,1,1,1.0,1.0
Diospyros kaki,1,0,1,0.14476460320460613,0.3126936942061339
Dipalta serpentina,0,2,2,1.0,1.0
Diplacus angustatus,8,15,23,0.01235984894699688,0.013453492698040059
Diplacus aurantiacus,3,0,3,0.0030335293929702875,0.000700171082788584
Diplacus bicolor,15,99,114,0.7904392277845351,0.7893934862975381
Diplacus bigelovii,1,2,3,0.3744588472376553,0.9141432822130974
Diplacus bolanderi,16,17,33,3.6364045590710586e-06,1.1247104385968361e-07
Diplacus calycinus,3,7,10,0.16639035724257725,0.3442511672283348
Diplacus constrictus,0,1,1,1.0,1.0
Diplacus douglasii,0,2,2,1.0,1.0
Diplacus fremontii,1,0,1,0.14476460320460613,0.3126936942061339
Diplacus grandiflorus,78,60,138,2.251818146930239e-30,4.711277866477563e-44
Diplacus graniticola,8,14,22,0.009210058558928957,0.008928110494935493
Diplacus jepsonii,0,5,5,1.0,0.7760428250025136
Diplacus kelloggii,46,34,80,5.907353843792879e-19,4.289241979878867e-27
Diplacus layneae,3,26,29,0.7908280788933808,0.7125101212946094
Diplacus leptaleus,0,64,64,0.00010007011384782763,0.0018440634624327277
Diplacus mephiticus,5,187,192,5.031015613325017e-08,4.762448045042356e-06
Diplacus nanus,0,5,5,1.0,0.7760428250025136
Diplacus parryi,1,23,24,0.24143280901572373,0.25202843593319213
Diplacus pictus,2,0,2,0.0209561639230412,0.01499159650771353
Diplacus pulchellus,4,37,41,0.5081741709490661,0.5240320746211788
Diplacus thompsonii,0,1,1,1.0,1.0
Diplacus torreyi,42,800,842,1.2868978862822838e-18,6.573535509707002e-15
Diplacus tricolor,1,0,1,0.14476460320460613,0.3126936942061339
Diplacus viscidus,9,0,9,2.7892926019110602e-08,9.215270667313031e-12
Diplodia tumefaciens,0,5,5,1.0,0.7760428250025136
Diplolepis bicolor,1,2,3,0.3744588472376553,0.9141432822130974
Diplolepis californica,0,3,3,1.0,1.0
Diplolepis polita,3,12,15,0.46864155961299403,0.8094879786929297
Diplolepis rosae,6,11,17,0.027184062695095077,0.03618509647236818
Dipsacus fullonum,1,5,6,1.0,1.0
Dipsacus sativus,2,0,2,0.0209561639230412,0.01499159650771353
Dipterostemon capitatus,65,52,117,5.3569269459613365e-25,7.420219458649484e-36
Discina ancilis,2,13,15,1.0,1.0
Discina montana,0,69,69,4.117433717759156e-05,0.0011661516995014269
Discus whitneyi,0,1,1,1.0,1.0
Disholcaspis spectabilis,4,4,8,0.01886984470142184,0.01861366248431812
Dissosteira pictipennis,3,0,3,0.0030335293929702875,0.000700171082788584
Distichlis spicata,1,1,2,0.2685730424867646,0.6723203844978234
Dittrichia graveolens,1,0,1,0.14476460320460613,0.3126936942061339
Ditylus quadricollis,0,2,2,1.0,1.0
Dodecatheon alpinum,1,118,119,3.0233443093456375e-07,4.1577038798093914e-05
Dodecatheon clevelandii,1,1,2,0.2685730424867646,0.6723203844978234
Dodecatheon hendersonii,50,39,89,7.199095608134948e-20,2.644702181482491e-28
Dodecatheon jeffreyanum,1,62,63,0.001010928420891077,0.006354359038863381
Dodecatheon pulchellum,0,1,1,1.0,1.0
Dolerosomus silaceus,1,0,1,0.14476460320460613,0.3126936942061339
Dolichovespula adulterina,0,2,2,1.0,1.0
Dolichovespula arenaria,1,77,78,0.00013842448479089385,0.0016242419153742304
Dolichovespula maculata,8,57,65,0.7264134837203702,0.7484155962255428
Donadinia nigrella,0,8,8,0.6124215574698968,0.5084255632839996
Dorymyrmex bicolor,1,0,1,0.14476460320460613,0.3126936942061339
Dorymyrmex insanus,2,0,2,0.0209561639230412,0.01499159650771353
Downingia bacigalupii,0,10,10,0.3757244358299004,0.39438447212016514
Downingia bicornuta,0,1,1,1.0,1.0
Downingia cuspidata,0,1,1,1.0,1.0
Downingia montana,0,5,5,1.0,0.7760428250025136
Draba albertina,0,7,7,0.6034645370398923,0.5813304975648097
Draba asterophora,0,11,11,0.38449278358904854,0.3492157200022511
Draba breweri,0,3,3,1.0,1.0
Draba californica,0,2,2,1.0,1.0
Draba densifolia,0,3,3,1.0,1.0
Draba incrassata,0,5,5,1.0,0.7760428250025136
Draba lemmonii,0,4,4,1.0,0.9105509465652237
Draba oligosperma,0,2,2,1.0,1.0
Draba praealta,0,4,4,1.0,0.9105509465652237
Draba sharsmithii,1,0,1,0.14476460320460613,0.3126936942061339
Draba sierrae,1,1,2,0.2685730424867646,0.6723203844978234
Draba verna,6,7,13,0.006303454978527976,0.004344972868583933
Dracunculus vulgaris,1,0,1,0.14476460320460613,0.3126936942061339
Draperia systyla,14,216,230,0.00010421240295680742,0.00042454859319159845
Drassodes saccatus,0,1,1,1.0,1.0
Drasteria adumbrata,1,16,17,0.4959452943950571,0.5076929481255973
Drasteria biformata,0,2,2,1.0,1.0
Drasteria convergens,0,4,4,1.0,0.9105509465652237
Drasteria divergens,0,9,9,0.37460992252836506,0.4468858706621094
Drasteria edwardsii,0,1,1,1.0,1.0
Drasteria hudsonica,0,1,1,1.0,1.0
Drasteria mirifica,0,1,1,1.0,1.0
Drasteria nubicola,0,1,1,1.0,1.0
Drasteria ochracea,0,4,4,1.0,0.9105509465652237
Drasteria parallela,0,1,1,1.0,1.0
Drasteria scrupulosa,1,4,5,0.5424646889787644,1.0
Drasteria stretchii,1,2,3,0.3744588472376553,0.9141432822130974
Drepanulatrix bifilata,0,6,6,0.6025804396089913,0.6688993551184468
Drepanulatrix carnearia,0,4,4,1.0,0.9105509465652237
Drepanulatrix falcataria,0,2,2,1.0,1.0
Drepanulatrix hulstii,0,3,3,1.0,1.0
Drepanulatrix nevadaria,0,2,2,1.0,1.0
Drepanulatrix quadraria,0,4,4,1.0,0.9105509465652237
Drepanulatrix unicalcararia,0,19,19,0.09746384240092232,0.14226189947649115
Drosera anglica,0,54,54,0.0003367115756713232,0.004649855763319928
Drosera obovata,0,1,1,1.0,1.0
Drosera rotundifolia,0,125,125,5.132312929899854e-09,7.671114628457068e-06
Drunella doddsi,0,1,1,1.0,1.0
Druon fullawayi,1,0,1,0.14476460320460613,0.3126936942061339
Drymocallis glandulosa,11,98,109,0.22123881515683005,0.24392826465318257
Drymocallis hansenii,0,1,1,1.0,1.0
Drymocallis lactea,0,51,51,0.0005177884379523655,0.006152910162560303
Dryobates nuttallii,12,7,19,1.56617110786348e-06,1.1637653225163648e-08
Dryobates pubescens,6,31,37,0.8140164913670949,0.9464615783811715
Dryobates scalaris,0,1,1,1.0,1.0
Dryocopus pileatus,29,271,300,0.016965566470180535,0.02217712491049167
Dryocosmus juliae,0,5,5,1.0,0.7760428250025136
Dryopteris arguta,53,25,78,1.1743263083838949e-26,3.7818077362621565e-40
Dryopteris filix-mas,0,1,1,1.0,1.0
Dryudella caerulea,1,0,1,0.14476460320460613,0.3126936942061339
Dudleya abramsii,2,7,9,0.6270956953788205,0.8518628753529384
Dudleya calcicola,0,4,4,1.0,0.9105509465652237
Dudleya cymosa,61,114,175,1.530959086285388e-11,4.0834126163191526e-14
Dufourea versatilis,0,1,1,1.0,1.0
Dulichium arundinaceum,0,4,4,1.0,0.9105509465652237
Dumetella carolinensis,1,0,1,0.14476460320460613,0.3126936942061339
Dysmicohermes disjunctus,0,1,1,1.0,1.0
Dysmicohermes ingens,1,6,7,1.0,1.0
Dysphania ambrosioides,2,0,2,0.0209561639230412,0.01499159650771353
Dysphania botrys,3,3,6,0.0431068667335647,0.05837521372070738
Dysstroma brunneata,0,10,10,0.3757244358299004,0.39438447212016514
Dysstroma colvillei,0,2,2,1.0,1.0
Dysstroma formosa,0,1,1,1.0,1.0
Dytoscotes pacificus,0,1,1,1.0,1.0
Echinargus isola,2,22,24,0.5653148798484595,0.5718848303294736
Echinocactus polycephalus,0,1,1,1.0,1.0
Echinocereus engelmannii,0,3,3,1.0,1.0
Echinocereus triglochidiatus,3,38,41,0.2658500834411175,0.2796809912723505
Echinodontium tinctorium,0,3,3,1.0,1.0
Echthrus abdominalis,0,1,1,1.0,1.0
Egira crucialis,0,4,4,1.0,0.9105509465652237
Egira februalis,0,1,1,1.0,1.0
Egira perlubens,1,13,14,0.7079821656760785,0.6890993041903317
Egira rubrica,0,2,2,1.0,1.0
Egira simplex,0,1,1,1.0,1.0
Egira variabilis,0,2,2,1.0,1.0
Egretta thula,0,1,1,1.0,1.0
Ehrendorferia chrysantha,2,9,11,0.6666373202113602,1.0
Elanus leucurus,1,0,1,0.14476460320460613,0.3126936942061339
Eleocharis bella,0,1,1,1.0,1.0
Eleocharis macrostachya,0,1,1,1.0,1.0
Eleodes alticola,0,1,1,1.0,1.0
Eleodes cordata,1,4,5,0.5424646889787644,1.0
Eleodes dentipes,0,1,1,1.0,1.0
Eleodes granosa,0,2,2,1.0,1.0
Eleodes hispilabris,0,1,1,1.0,1.0
Eleodes obscura,0,2,2,1.0,1.0
Eleodes osculans,2,0,2,0.0209561639230412,0.01499159650771353
Eleodes scabricula,0,3,3,1.0,1.0
Elgaria coerulea,22,230,252,0.00905038460178996,0.012260460502358968
Elgaria multicarinata,107,71,178,1.3753632373794015e-44,2.432230713571646e-66
Elgaria panamintina,1,0,1,0.14476460320460613,0.3126936942061339
Elkalyce amyntula,2,11,13,1.0,1.0
Elkalyce comyntas,0,1,1,1.0,1.0
Elodea canadensis,0,12,12,0.2360424886052977,0.31009055076592434
Elodea nuttallii,0,2,2,1.0,1.0
Elymus elymoides,6,109,115,0.0031475609865267195,0.007141410551006912
Elymus glaucus,1,7,8,1.0,1.0
Elymus violaceus,0,2,2,1.0,1.0
Emblethis vicarius,1,0,1,0.14476460320460613,0.3126936942061339
Emmelina monodactyla,1,2,3,0.3744588472376553,0.9141432822130974
Emmenanthe penduliflora,2,7,9,0.6270956953788205,0.8518628753529384
Empidonax difficilis,8,25,33,0.1321293730219027,0.1779319665656241
Empidonax hammondii,2,15,17,1.0,1.0
Empidonax minimus,0,1,1,1.0,1.0
Empidonax oberholseri,1,62,63,0.001010928420891077,0.006354359038863381
Empidonax traillii,2,4,6,0.21128172197002185,0.4637992200137968
Empidonax wrightii,1,9,10,1.0,1.0
Empis barbatoides,2,0,2,0.0209561639230412,0.01499159650771353
Enallagma annexum,0,2,2,1.0,1.0
Enallagma boreale,0,3,3,1.0,1.0
Enallagma carunculatum,2,2,4,0.10278607328810296,0.1906437976216683
Encelia actoni,0,3,3,1.0,1.0
Endogone pisiformis,1,0,1,0.14476460320460613,0.3126936942061339
Endomychus limbatus,0,2,2,1.0,1.0
Endoptychum depressum,0,2,2,1.0,1.0
Endotropis crocea,13,7,20,3.4632594883488514e-07,1.0342272224237015e-09
Enemion occidentale,20,2,22,2.7902616583335998e-15,4.7768652065916936e-23
Enerthenema melanospermum,0,1,1,1.0,1.0
Enerthenema papillatum,2,1,3,0.056801432979852025,0.0803492820202322
Enicospilus purgatus,0,1,1,1.0,1.0
Enoclerus eximius,0,2,2,1.0,1.0
Enoclerus lecontei,0,2,2,1.0,1.0
Enoclerus moestus,0,1,1,1.0,1.0
Enoclerus schaefferi,0,1,1,1.0,1.0
Enoclerus sphegeus,1,5,6,1.0,1.0
Ensatina eschscholtzii,85,212,297,2.9591337141213765e-10,7.39866124677111e-12
Entoloma cetratum,2,2,4,0.10278607328810296,0.1906437976216683
Entoloma clandestinum,0,1,1,1.0,1.0
Entoloma cyaneum,0,1,1,1.0,1.0
Entoloma edulis,0,2,2,1.0,1.0
Entoloma exalbidum,0,2,2,1.0,1.0
Entoloma ferruginans,1,0,1,0.14476460320460613,0.3126936942061339
Entoloma foliocontusum,0,2,2,1.0,1.0
Entoloma formosum,1,0,1,0.14476460320460613,0.3126936942061339
Entoloma hirtipes,2,0,2,0.0209561639230412,0.01499159650771353
Entoloma holoconiotum,1,43,44,0.01643618076915838,0.036921759051915914
Entoloma lividoalbum,0,1,1,1.0,1.0
Entoloma medianox,2,0,2,0.0209561639230412,0.01499159650771353
Entoloma occidentale,0,4,4,1.0,0.9105509465652237
Entoloma sericeum,3,0,3,0.0030335293929702875,0.000700171082788584
Entoloma subsaundersii,1,0,1,0.14476460320460613,0.3126936942061339
Entoloma undatum,0,2,2,1.0,1.0
Entoloma vernum,0,5,5,1.0,0.7760428250025136
Entomobrya suzannae,0,1,1,1.0,1.0
Epargyreus clarus,10,45,55,0.44150930144220213,0.5555599787161207
Ephedra viridis,9,79,88,0.2918624095430634,0.3263014432385977
Ephestiodes erythrella,0,1,1,1.0,1.0
Epicauta puncticollis,0,7,7,0.6034645370398923,0.5813304975648097
Epilobium brachycarpum,0,16,16,0.15161267346782015,0.19687992504129675
Epilobium campestre,0,1,1,1.0,1.0
Epilobium canum,27,184,211,0.5570086816064916,0.5510789810918664
Epilobium ciliatum,4,34,38,0.6463210485055066,0.6443925626791442
Epilobium densiflorum,6,7,13,0.006303454978527976,0.004344972868583933
Epilobium glaberrimum,0,3,3,1.0,1.0
Epilobium howellii,0,3,3,1.0,1.0
Epilobium minutum,0,1,1,1.0,1.0
Epilobium obcordatum,2,67,69,0.003075156325946015,0.010388071355108063
Epilobium oregonense,0,2,2,1.0,1.0
Epinotia castaneana,0,4,4,1.0,0.9105509465652237
Epinotia miscana,0,1,1,1.0,1.0
Epinotia nigralbana,1,6,7,1.0,1.0
Epinotia purpuriciliana,0,2,2,1.0,1.0
Epinotia radicana,0,1,1,1.0,1.0
Epinotia subplicana,0,1,1,1.0,1.0
Epinotia terracoctana,0,4,4,1.0,0.9105509465652237
Epinotia wrighti,0,1,1,1.0,1.0
Epipactis gigantea,6,38,44,1.0,1.0
Epipactis helleborine,0,1,1,1.0,1.0
Epirrhoe alternata,0,1,1,1.0,1.0
Epirrhoe plebeculata,0,1,1,1.0,1.0
Epirrita autumnata,0,2,2,1.0,1.0
Epitheca canis,3,8,11,0.2054644031680506,0.4367258119699784
Epitheca spinigera,0,1,1,1.0,1.0
Eptesicus fuscus,2,6,8,0.3262180684327187,0.7311980927864552
Equisetum arvense,16,164,180,0.03345156731286773,0.04281342936904904
Equisetum braunii,3,1,4,0.010816792675262966,0.00633924523846032
Equisetum ferrissii,0,4,4,1.0,0.9105509465652237
Equisetum hyemale,10,55,65,0.8595490561185133,0.9746020315192719
Equisetum laevigatum,2,25,27,0.41609323465062054,0.4410007741051609
Equisetum praealtum,16,43,59,0.014174798628436184,0.010019294556640468
Equisetum telmateia,2,4,6,0.21128172197002185,0.4637992200137968
Equus asinus,0,1,1,1.0,1.0
Equus caballus,1,0,1,0.14476460320460613,0.3126936942061339
Erannis vancouverensis,2,0,2,0.0209561639230412,0.01499159650771353
Eranthis hyemalis,0,1,1,1.0,1.0
Eremobina unicincta,0,2,2,1.0,1.0
Eremochrysa punctinervis,0,1,1,1.0,1.0
Eremocoris borealis,0,1,1,1.0,1.0
Eremogone cliftonii,0,5,5,1.0,0.7760428250025136
Eremogone congesta,0,12,12,0.2360424886052977,0.31009055076592434
Eremogone ferrisiae,1,1,2,0.2685730424867646,0.6723203844978234
Eremogone kingii,1,93,94,1.1917253710620066e-05,0.0003851732561097435
Eremogone macradenia,1,2,3,0.3744588472376553,0.9141432822130974
Eremophila alpestris,1,1,2,0.2685730424867646,0.6723203844978234
Eremothera boothii,3,0,3,0.0030335293929702875,0.000700171082788584
Eresia aveyrona,23,136,159,1.0,1.0
Erethizon dorsatus,1,26,27,0.1664908585838914,0.1876753474441988
Eriastrum densifolium,3,8,11,0.2054644031680506,0.4367258119699784
Eriastrum pluriflorum,1,2,3,0.3744588472376553,0.9141432822130974
Eriastrum signatum,0,8,8,0.6124215574698968,0.5084255632839996
Eriastrum sparsiflorum,2,2,4,0.10278607328810296,0.1906437976216683
Eriastrum tracyi,4,0,4,0.00043910829886184923,3.314336839661014e-05
Eriastrum wilcoxii,0,11,11,0.38449278358904854,0.3492157200022511
Erica carnea,0,1,1,1.0,1.0
Ericameria albida,0,1,1,1.0,1.0
Ericameria arborescens,7,3,10,0.00010655132026942219,5.604574097560587e-06
Ericameria bloomeri,0,39,39,0.0046877939621657125,0.019179555698833974
Ericameria cuneata,10,29,39,0.0642197959390185,0.0794035333413149
Ericameria discoidea,0,14,14,0.24486350799097997,0.24618548812479032
Ericameria gilmanii,1,0,1,0.14476460320460613,0.3126936942061339
Ericameria greenei,0,1,1,1.0,1.0
Ericameria linearifolia,4,0,4,0.00043910829886184923,3.314336839661014e-05
Ericameria nauseosa,9,79,88,0.2918624095430634,0.3263014432385977
Ericameria parryi,0,7,7,0.6034645370398923,0.5813304975648097
Ericameria suffruticosa,0,15,15,0.14994170356869613,0.21998124924271661
Ericameria teretifolia,0,2,2,1.0,1.0
Erigeron algidus,0,6,6,0.6025804396089913,0.6688993551184468
Erigeron annuus,0,3,3,1.0,1.0
Erigeron aphanactis,1,23,24,0.24143280901572373,0.25202843593319213
Erigeron argentatus,1,27,28,0.1715694357066057,0.17021690282597887
Erigeron barbellulatus,0,1,1,1.0,1.0
Erigeron bloomeri,0,2,2,1.0,1.0
Erigeron breweri,1,11,12,1.0,0.845714857147599
Erigeron canadensis,3,11,14,0.442580497264679,0.7192143479491181
Erigeron clokeyi,0,15,15,0.14994170356869613,0.21998124924271661
Erigeron compactus,2,6,8,0.3262180684327187,0.7311980927864552
Erigeron compositus,0,23,23,0.06652127337221461,0.09355974164186621
Erigeron coulteri,0,144,144,2.6229168702051747e-10,1.4326147149738688e-06
Erigeron eatonii,0,1,1,1.0,1.0
Erigeron foliosus,6,2,8,0.00019772693610894856,1.2839299064071593e-05
Erigeron glacialis,1,78,79,0.0001464108284038023,0.0014838993932431233
Erigeron inornatus,1,10,11,1.0,0.9368824658167821
Erigeron lonchophyllus,0,2,2,1.0,1.0
Erigeron miser,0,20,20,0.10203106758234803,0.12794167189413608
Erigeron pygmaeus,0,5,5,1.0,0.7760428250025136
Erigeron tener,0,1,1,1.0,1.0
Erigeron uncialis,1,4,5,0.5424646889787644,1.0
Erigeron vagus,0,1,1,1.0,1.0
Eriocoma hymenoides,3,29,32,0.6141064871869613,0.5693565395219757
Eriocoma lemmonii,0,1,1,1.0,1.0
Eriocoma nevadensis,0,1,1,1.0,1.0
Eriocoma occidentalis,0,5,5,1.0,0.7760428250025136
Eriocoma parishii,0,3,3,1.0,1.0
Eriocoma webberi,0,8,8,0.6124215574698968,0.5084255632839996
Eriocraniella aurosparsella,0,1,1,1.0,1.0
Eriodictyon californicum,60,58,118,1.3791640010312496e-20,1.2403203268837488e-28
Eriogonum baileyi,1,3,4,0.4650164385481151,1.0
Eriogonum brachyanthum,1,1,2,0.2685730424867646,0.6723203844978234
Eriogonum breedlovei,1,2,3,0.3744588472376553,0.9141432822130974
Eriogonum caespitosum,5,64,69,0.12045113358548562,0.12452780637297718
Eriogonum cernuum,0,1,1,1.0,1.0
Eriogonum deflexum,3,7,10,0.16639035724257725,0.3442511672283348
Eriogonum douglasii,0,2,2,1.0,1.0
Eriogonum elatum,0,19,19,0.09746384240092232,0.14226189947649115
Eriogonum elongatum,1,0,1,0.14476460320460613,0.3126936942061339
Eriogonum esmeraldense,0,5,5,1.0,0.7760428250025136
Eriogonum fasciculatum,2,2,4,0.10278607328810296,0.1906437976216683
Eriogonum gracilipes,0,41,41,0.0029382927234686395,0.015834078394456372
Eriogonum heermannii,0,16,16,0.15161267346782015,0.19687992504129675
Eriogonum heracleoides,0,3,3,1.0,1.0
Eriogonum incanum,0,107,107,1.043220926270814e-07,3.7964275938994735e-05
Eriogonum inerme,2,0,2,0.0209561639230412,0.01499159650771353
Eriogonum inflatum,1,0,1,0.14476460320460613,0.3126936942061339
Eriogonum kennedyi,2,16,18,1.0,0.9435167712853587
Eriogonum latens,2,5,7,0.2688137426846044,0.6011437582684053
Eriogonum lobbii,0,60,60,0.00014378007469898363,0.002665672747563187
Eriogonum luteolum,0,3,3,1.0,1.0
Eriogonum marifolium,0,17,17,0.15747128520432685,0.17645428752866515
Eriogonum microtheca,2,16,18,1.0,0.9435167712853587
Eriogonum nidularium,1,1,2,0.2685730424867646,0.6723203844978234
Eriogonum nudum,27,397,424,2.49916041217909e-07,2.8522981867819416e-06
Eriogonum nummulare,2,0,2,0.0209561639230412,0.01499159650771353
Eriogonum ochrocephalum,1,0,1,0.14476460320460613,0.3126936942061339
Eriogonum ovalifolium,5,89,94,0.00789524710336955,0.017442931836765204
Eriogonum palmerianum,0,5,5,1.0,0.7760428250025136
Eriogonum panamintense,1,22,23,0.23832747917939356,0.27824213268427256
Eriogonum polypodum,1,5,6,1.0,1.0
Eriogonum pusillum,1,0,1,0.14476460320460613,0.3126936942061339
Eriogonum rosense,1,5,6,1.0,1.0
Eriogonum roseum,1,1,2,0.2685730424867646,0.6723203844978234
Eriogonum rupinum,1,5,6,1.0,1.0
Eriogonum saxatile,8,4,12,5.508489772806841e-05,2.266634219630844e-06
Eriogonum spergulinum,2,32,34,0.22050004271378132,0.23776748963474853
Eriogonum twisselmanii,0,1,1,1.0,1.0
Eriogonum umbellatum,24,478,502,3.5862276063478494e-12,9.467309907142286e-10
Eriogonum ursinum,0,21,21,0.06152025756350138,0.11517086832716916
Eriogonum vimineum,2,0,2,0.0209561639230412,0.01499159650771353
Eriogonum wrightii,7,87,94,0.055677605579109106,0.07331994196631568
Erioneuron pilosum,0,1,1,1.0,1.0
Eriophorum gracile,0,24,24,0.03967208129449859,0.08442030606095953
Eriophyes emarginatae,1,1,2,0.2685730424867646,0.6723203844978234
Eriophyes laevis,0,9,9,0.37460992252836506,0.4468858706621094
Eriophyes sorbi,0,5,5,1.0,0.7760428250025136
Eriophyllum ambiguum,3,1,4,0.010816792675262966,0.00633924523846032
Eriophyllum confertiflorum,5,4,9,0.004804892843884087,0.0024551155675152643
Eriophyllum congdonii,4,4,8,0.01886984470142184,0.01861366248431812
Eriophyllum lanatum,36,146,182,0.04533781112499115,0.05372309930372183
Eriophyllum pringlei,7,10,17,0.006793613907534162,0.005366650789691497
Eriophyllum wallacei,1,0,1,0.14476460320460613,0.3126936942061339
Eriosporangium evadens,1,0,1,0.14476460320460613,0.3126936942061339
Eristalis arbustorum,0,1,1,1.0,1.0
Eristalis flavipes,0,1,1,1.0,1.0
Eristalis hirta,5,43,48,0.5403632661094118,0.5522830056832175
Eristalis nemorum,0,2,2,1.0,1.0
Eristalis stipator,2,12,14,1.0,1.0
Eristalis tenax,1,9,10,1.0,1.0
Erodium botrys,11,2,13,3.4286171116249e-08,1.0962914032288149e-11
Erodium brachycarpum,0,2,2,1.0,1.0
Erodium cicutarium,46,39,85,1.573248569113069e-17,1.3836826923970116e-24
Erodium moschatum,0,1,1,1.0,1.0
Erynnis icelus,0,1,1,1.0,1.0
Erynnis pacuvius,0,5,5,1.0,0.7760428250025136
Erynnis persius,0,2,2,1.0,1.0
Erynnis propertius,15,90,105,1.0,1.0
Erynnis tristis,7,3,10,0.00010655132026942219,5.604574097560587e-06
Erysimum capitatum,45,369,414,0.03586308021142702,0.043589852343996406
Erysimum perenne,2,22,24,0.5653148798484595,0.5718848303294736
Erysiphe azaleae,0,1,1,1.0,1.0
Erysiphe pisi,1,0,1,0.14476460320460613,0.3126936942061339
Erythemis collocata,14,14,28,9.414962157197794e-06,3.894821454573845e-07
Erythranthe acutidens,7,3,10,0.00010655132026942219,5.604574097560587e-06
Erythranthe androsacea,3,1,4,0.010816792675262966,0.00633924523846032
Erythranthe arenaria,7,47,54,1.0,0.9023226685397393
Erythranthe barbata,35,54,89,8.256171980205052e-09,7.350259401444189e-11
Erythranthe bicolor,43,220,263,0.3806276179266228,0.4375631288491958
Erythranthe breweri,11,303,314,1.8872899935664999e-10,5.02720887212359e-08
Erythranthe calcicola,0,1,1,1.0,1.0
Erythranthe cardinalis,91,301,392,3.7000067591625196e-06,1.2363280633482184e-06
Erythranthe carsonensis,0,1,1,1.0,1.0
Erythranthe corallina,0,67,67,6.67329277773998e-05,0.001400350730518439
Erythranthe discolor,11,16,27,0.0007982742016077558,0.0003117217807645189
Erythranthe erubescens,1,539,540,2.478660460449439e-35,6.000756744454118e-21
Erythranthe filicaulis,3,17,20,1.0,1.0
Erythranthe filicifolia,4,9,13,0.10658251785953915,0.20215021085988086
Erythranthe floribunda,1,5,6,1.0,1.0
Erythranthe glaucescens,17,1,18,8.335904699809176e-14,1.3058217931238115e-20
Erythranthe gracilipes,7,6,13,0.0010192335799894875,0.0002724004392891465
Erythranthe guttata,27,231,258,0.07592430743023058,0.0811890474575195
Erythranthe howaldiae,0,1,1,1.0,1.0
Erythranthe inconspicua,4,2,6,0.005153189017352294,0.0022646484484871816
Erythranthe laciniata,14,40,54,0.030272064061494602,0.02794321118762762
Erythranthe linearifolia,0,1,1,1.0,1.0
Erythranthe marmorata,2,0,2,0.0209561639230412,0.01499159650771353
Erythranthe microphylla,0,22,22,0.06301881478000051,0.10376364830846786
Erythranthe montioides,2,85,87,0.00032812802939583355,0.0020949245399314634
Erythranthe moschata,30,465,495,6.062793885473795e-09,1.408491189396655e-07
Erythranthe nasuta,9,28,37,0.09963963246851336,0.1418452634286116
Erythranthe pardalis,1,0,1,0.14476460320460613,0.3126936942061339
Erythranthe parishii,0,1,1,1.0,1.0
Erythranthe primuloides,10,476,486,7.711850638865633e-21,1.1109469056332465e-14
Erythranthe ptilota,2,0,2,0.0209561639230412,0.01499159650771353
Erythranthe pulsiferae,4,2,6,0.005153189017352294,0.0022646484484871816
Erythranthe rubella,1,8,9,1.0,1.0
Erythranthe shevockii,10,3,13,7.566025239371125e-07,1.9133243600268355e-09
Erythranthe sierrae,1,0,1,0.14476460320460613,0.3126936942061339
Erythranthe suksdorfii,2,21,23,0.5652342527632244,0.6229726880589948
Erythranthe tilingii,1,59,60,0.0015072205977971413,0.008366397391801218
Erythronium multiscapideum,34,9,43,4.121626815239593e-21,2.990133788561453e-32
Erythronium pluriflorum,0,9,9,0.37460992252836506,0.4468858706621094
Erythronium purpurascens,0,153,153,7.542903407581463e-11,6.48902435426559e-07
Erythronium pusaterii,2,8,10,0.6456440117183423,0.9624710515030661
Erythronium taylorii,1,1,2,0.2685730424867646,0.6723203844978234
Erythronium tuolumnense,2,5,7,0.2688137426846044,0.6011437582684053
Eschscholzia caespitosa,11,3,14,1.388223409795988e-07,1.224996553116888e-10
Eschscholzia californica,44,19,63,3.870546666583223e-23,7.806316311224339e-35
Eschscholzia lobbii,3,0,3,0.0030335293929702875,0.000700171082788584
Eschscholzia minutiflora,1,1,2,0.2685730424867646,0.6723203844978234
Esperia sulphurella,1,0,1,0.14476460320460613,0.3126936942061339
Estigmene acrea,1,0,1,0.14476460320460613,0.3126936942061339
Ethmia discostrigella,0,1,1,1.0,1.0
Etiella zinckenella,1,3,4,0.4650164385481151,1.0
Etorofus obliteratus,0,32,32,0.010653294055563268,0.03786379733207584
Eublemma minima,1,1,2,0.2685730424867646,0.6723203844978234
Eubrianax edwardsii,0,2,2,1.0,1.0
Eucalyptus camaldulensis,0,1,1,1.0,1.0
Eucapnopsis brevicauda,0,1,1,1.0,1.0
Eucephalus breweri,0,189,189,3.21022981104599e-13,2.7694144158672325e-08
Euceratia castella,0,3,3,1.0,1.0
Eucerceris provancheri,0,1,1,1.0,1.0
Euchloe ausonides,0,5,5,1.0,0.7760428250025136
Euchloe hyantis,0,6,6,0.6025804396089913,0.6688993551184468
Euclidia ardita,1,0,1,0.14476460320460613,0.3126936942061339
Euclytia flava,1,0,1,0.14476460320460613,0.3126936942061339
Eucopina bobana,0,4,4,1.0,0.9105509465652237
Eucopina ponderosa,0,3,3,1.0,1.0
Eucopina rescissoriana,0,1,1,1.0,1.0
Eucopina siskiyouana,0,5,5,1.0,0.7760428250025136
Eucosma clavana,0,1,1,1.0,1.0
Eucosma oregonensis,0,1,1,1.0,1.0
Eucrypta micrantha,2,6,8,0.3262180684327187,0.7311980927864552
Eudonia spaldingalis,0,1,1,1.0,1.0
Eudonia spenceri,0,1,1,1.0,1.0
Eudrepanulatrix rectifascia,2,28,30,0.303117213659443,0.3389041172310913
Euhexomyza schineri,0,11,11,0.38449278358904854,0.3492157200022511
Eulabis bicarinata,0,2,2,1.0,1.0
Eulithis propulsata,0,3,3,1.0,1.0
Eulithis xylina,0,1,1,1.0,1.0
Eulonchus sapphirinus,0,4,4,1.0,0.9105509465652237
Eulonchus smaragdinus,0,2,2,1.0,1.0
Eulonchus tristis,0,3,3,1.0,1.0
Eumenes crucifera,0,1,1,1.0,1.0
Eumorpha achemon,9,5,14,2.785639213432983e-05,8.786751400281266e-07
Euodynerus annulatus,0,1,1,1.0,1.0
Euodynerus pratensis,0,1,1,1.0,1.0
Euonymus americanus,0,1,1,1.0,1.0
Euonymus occidentalis,0,1,1,1.0,1.0
Euophrys monadnock,0,1,1,1.0,1.0
Eupeodes fumipennis,8,12,20,0.004741703787194284,0.003428996841163759
Eupeodes snowi,0,2,2,1.0,1.0
Eupeodes volucris,4,8,12,0.08293252313214843,0.1480937371178578
Euphagus cyanocephalus,17,269,286,9.88442732350448e-06,5.8248725921306744e-05
Euphilotes battoides,2,12,14,1.0,1.0
Euphilotes enoptes,4,27,31,1.0,1.0
Euphorbia albomarginata,1,0,1,0.14476460320460613,0.3126936942061339
Euphorbia crenulata,5,6,11,0.013693210356916412,0.012717642011991449
Euphorbia fendleri,1,13,14,0.7079821656760785,0.6890993041903317
Euphorbia lathyris,1,0,1,0.14476460320460613,0.3126936942061339
Euphorbia maculata,1,5,6,1.0,1.0
Euphorbia oblongata,13,5,18,5.1012562678773784e-08,3.3993804082578516e-11
Euphorbia ocellata,0,1,1,1.0,1.0
Euphorbia prostrata,0,1,1,1.0,1.0
Euphorbia rigida,2,0,2,0.0209561639230412,0.01499159650771353
Euphorbia serpillifolia,1,15,16,0.4958553183213633,0.5619415773454699
Euphorbia vallis-mortae,2,0,2,0.0209561639230412,0.01499159650771353
Euphyes vestris,0,12,12,0.2360424886052977,0.31009055076592434
Eupithecia cretaceata,0,14,14,0.24486350799097997,0.24618548812479032
Eupithecia graefii,0,5,5,1.0,0.7760428250025136
Eupithecia misturata,0,1,1,1.0,1.0
Eupithecia satyrata,0,1,1,1.0,1.0
Euproserpinus phaeton,1,0,1,0.14476460320460613,0.3126936942061339
Euptoieta claudia,0,1,1,1.0,1.0
Eurois nigra,0,1,1,1.0,1.0
Eurybia integrifolia,0,88,88,2.0623530127090603e-06,0.00020821588722870854
Eurybia radulina,0,11,11,0.38449278358904854,0.3492157200022511
Eurygaster shoshone,1,0,1,0.14476460320460613,0.3126936942061339
Euryopis formosa,0,1,1,1.0,1.0
Eustroma semiatrata,1,14,15,0.7118339050632088,0.6221922979706558
Euthamia occidentalis,0,1,1,1.0,1.0
Euthyatira lorata,0,1,1,1.0,1.0
Euthyatira semicircularis,0,7,7,0.6034645370398923,0.5813304975648097
Eutreta diana,2,3,5,0.15522343689242213,0.32387652224382535
Eutricopis nexilis,0,2,2,1.0,1.0
Euxoa annulipes,0,1,1,1.0,1.0
Euxoa auxiliaris,0,1,1,1.0,1.0
Euxoa divergens,0,1,1,1.0,1.0
Euxoa murdocki,0,2,2,1.0,1.0
Euxoa obeliscoides,0,1,1,1.0,1.0
Euxoa pluralis,0,11,11,0.38449278358904854,0.3492157200022511
Euxoa tessellata,0,1,1,1.0,1.0
Evarcha proszynskii,4,7,11,0.06219290144309395,0.10212099408086615
Evergestis funalis,0,1,1,1.0,1.0
Evergestis subterminalis,0,3,3,1.0,1.0
Evernia prunastri,21,18,39,1.0187369046491761e-08,1.3742176137152837e-11
Exidia glandulosa,4,0,4,0.00043910829886184923,3.314336839661014e-05
Exitianus exitiosus,0,1,1,1.0,1.0
Exobasidium myrtilli,0,3,3,1.0,1.0
Exoprosopa caliptera,0,1,1,1.0,1.0
Fabiola quinqueferella,0,2,2,1.0,1.0
Falco columbarius,1,5,6,1.0,1.0
Falco mexicanus,0,9,9,0.37460992252836506,0.4468858706621094
Falco peregrinus,3,15,18,0.7373365905564824,1.0
Falco sparverius,7,34,41,0.6552105726924655,0.8020884268605912
Faxonius virilis,1,1,2,0.2685730424867646,0.6723203844978234
Fazia micrura,0,4,4,1.0,0.9105509465652237
Felis catus,14,6,20,2.878197927385772e-08,1.588649631845276e-11
Feralia deceptiva,0,1,1,1.0,1.0
Feralia februalis,1,1,2,0.2685730424867646,0.6723203844978234
Ferdinandea croesus,1,2,3,0.3744588472376553,0.9141432822130974
Festuca idahoensis,0,1,1,1.0,1.0
Festuca kingii,0,1,1,1.0,1.0
Festuca microstachys,1,1,2,0.2685730424867646,0.6723203844978234
Festuca occidentalis,3,2,5,0.02413002787627292,0.023975245305455268
Festuca viridula,0,1,1,1.0,1.0
Ficus carica,16,3,19,2.3160066302308548e-11,9.32449831626713e-17
Fimbristylis thermalis,2,0,2,0.0209561639230412,0.01499159650771353
Fissidens bryoides,1,0,1,0.14476460320460613,0.3126936942061339
Flammulina rossica,0,1,1,1.0,1.0
Flammulina velutipes,1,0,1,0.14476460320460613,0.3126936942061339
Floccularia albolanaripes,25,38,63,8.758623349518461e-07,3.633903522445717e-08
Floerkea proserpinacoides,0,1,1,1.0,1.0
Fluminicola turbiniformis,0,1,1,1.0,1.0
Foeniculum vulgare,1,3,4,0.4650164385481151,1.0
Fomes arctostaphyli,7,3,10,0.00010655132026942219,5.604574097560587e-06
Fomitopsis mounceae,3,98,101,0.00030237673561258455,0.001656422610604771
Fomitopsis ochracea,0,2,2,1.0,1.0
Fomitopsis officinalis,0,7,7,0.6034645370398923,0.5813304975648097
Fontinalis antipyretica,0,1,1,1.0,1.0
Fontinalis neomexicana,1,1,2,0.2685730424867646,0.6723203844978234
Forestiera pubescens,0,2,2,1.0,1.0
Forficula dentata,1,6,7,1.0,1.0
Formica accreta,0,1,1,1.0,1.0
Formica argentea,0,1,1,1.0,1.0
Formica aserva,0,5,5,1.0,0.7760428250025136
Formica integroides,0,2,2,1.0,1.0
Formica moki,0,1,1,1.0,1.0
Formica neorufibarbis,0,4,4,1.0,0.9105509465652237
Formica obscuripes,1,5,6,1.0,1.0
Formica sibylla,0,2,2,1.0,1.0
Formica subaenescens,0,1,1,1.0,1.0
Formica subpolita,3,1,4,0.010816792675262966,0.00633924523846032
Fragaria ananassa,0,1,1,1.0,1.0
Fragaria vesca,41,192,233,0.19130527326302427,0.20723776496119073
Fragaria virginiana,2,200,202,1.783149502496247e-11,8.783610438129939e-08
Frangula californica,50,37,87,1.8477021696747984e-20,2.3847306152244676e-29
Frangula purshiana,0,9,9,0.37460992252836506,0.4468858706621094
Frangula rubra,8,17,25,0.02090801268499863,0.02738090737744616
Frasera albicaulis,0,9,9,0.37460992252836506,0.4468858706621094
Frasera puberulenta,1,13,14,0.7079821656760785,0.6890993041903317
Frasera speciosa,0,198,198,5.407198506774806e-14,1.262258795249728e-08
Frasera tubulosa,8,21,29,0.059749219109074964,0.08139272383339777
Fraxinus dipetala,0,1,1,1.0,1.0
Fraxinus latifolia,3,0,3,0.0030335293929702875,0.000700171082788584
Fremontodendron californicum,13,15,28,5.333206043861835e-05,5.708719344125288e-06
Fritillaria agrestis,2,0,2,0.0209561639230412,0.01499159650771353
Fritillaria atropurpurea,11,150,161,0.004726689613829696,0.008153282616000913
Fritillaria brandegeei,4,3,7,0.0106471288054473,0.007559096939159896
Fritillaria eastwoodiae,17,3,20,3.936015337261187e-12,5.327158487448075e-18
Fritillaria micrantha,64,85,149,4.25821355861138e-17,1.573573173174745e-22
Fritillaria pinetorum,6,45,51,0.693907352611162,0.725255933012846
Fritillaria pudica,1,18,19,0.5081076590495464,0.41485136099373987
Fritillaria recurva,25,69,94,0.0018698420390100168,0.001405194806727432
Frontinella pyramitela,2,1,3,0.056801432979852025,0.0803492820202322
Fulica americana,1,11,12,1.0,0.845714857147599
Fuligo intermedia,0,1,1,1.0,1.0
Fuligo septica,3,89,92,0.0008871402438692227,0.003615961975569871
Funaria hygrometrica,2,22,24,0.5653148798484595,0.5718848303294736
Furcula scolopendrina,1,19,20,0.3447987554750399,0.37521694522958526
Fuscocephaloziopsis lunulifolia,0,1,1,1.0,1.0
Fuscopostia fragilis,0,1,1,1.0,1.0
Gaillardia pulchella,1,9,10,1.0,1.0
Galerina badipes,6,7,13,0.006303454978527976,0.004344972868583933
Galerina marginata,9,10,19,0.0006451642095409557,0.00017764735335142312
Galerina semilanceata,3,0,3,0.0030335293929702875,0.000700171082788584
Galerina stylifera,0,1,1,1.0,1.0
Galerina vittiformis,0,1,1,1.0,1.0
Galeropsis polytrichoides,0,15,15,0.14994170356869613,0.21998124924271661
Galeruca rudis,0,2,2,1.0,1.0
Galerucella nymphaeae,0,1,1,1.0,1.0
Galgula partita,2,0,2,0.0209561639230412,0.01499159650771353
Galium angustifolium,1,0,1,0.14476460320460613,0.3126936942061339
Galium aparine,25,11,36,1.193587778857911e-13,6.410233091251928e-20
Galium bifolium,0,2,2,1.0,1.0
Galium bolanderi,0,1,1,1.0,1.0
Galium californicum,0,1,1,1.0,1.0
Galium grayanum,0,1,1,1.0,1.0
Galium hallii,1,0,1,0.14476460320460613,0.3126936942061339
Galium multiflorum,1,2,3,0.3744588472376553,0.9141432822130974
Galium odoratum,1,5,6,1.0,1.0
Galium parisiense,1,0,1,0.14476460320460613,0.3126936942061339
Galium porrigens,3,1,4,0.010816792675262966,0.00633924523846032
Galium sparsiflorum,1,3,4,0.4650164385481151,1.0
Galium stellatum,1,3,4,0.4650164385481151,1.0
Galium trifidum,1,21,22,0.3559263140695814,0.3072913058315549
Galium triflorum,0,47,47,0.0012664264058445166,0.008959167191137872
Gallinago delicata,0,4,4,1.0,0.9105509465652237
Gallinula chloropus,1,0,1,0.14476460320460613,0.3126936942061339
Gallowayella hasseana,1,0,1,0.14476460320460613,0.3126936942061339
Gallus gallus,0,1,1,1.0,1.0
Gambelia wislizenii,3,10,13,0.41916983303031286,0.626122924488651
Gambusia affinis,1,1,2,0.2685730424867646,0.6723203844978234
Gammarotettix bilobatus,0,4,4,1.0,0.9105509465652237
Gammarotettix bovis,2,0,2,0.0209561639230412,0.01499159650771353
Gammarotettix cyclocercus,2,1,3,0.056801432979852025,0.0803492820202322
Gammarus lacustris,0,3,3,1.0,1.0
Gamochaeta americana,0,1,1,1.0,1.0
Ganoderma applanatum,0,11,11,0.38449278358904854,0.3492157200022511
Ganoderma brownii,0,1,1,1.0,1.0
Ganoderma oregonense,2,50,52,0.027928429005604744,0.04750362184344893
Ganoderma polychromum,0,5,5,1.0,0.7760428250025136
Garrya elliptica,1,0,1,0.14476460320460613,0.3126936942061339
Garrya flavescens,2,1,3,0.056801432979852025,0.0803492820202322
Garrya fremontii,2,5,7,0.2688137426846044,0.6011437582684053
Gastroboletus amyloideus,0,2,2,1.0,1.0
Gastroboletus turbinatus,0,6,6,0.6025804396089913,0.6688993551184468
Gastroboletus vividus,0,1,1,1.0,1.0
Gastrophysa cyanea,0,1,1,1.0,1.0
Gastropila fumosa,0,21,21,0.06152025756350138,0.11517086832716916
Gaultheria humifusa,0,5,5,1.0,0.7760428250025136
Gaultheria ovatifolia,0,11,11,0.38449278358904854,0.3492157200022511
Gautieria monticola,0,6,6,0.6025804396089913,0.6688993551184468
Gavia immer,0,2,2,1.0,1.0
Gayophytum diffusum,1,39,40,0.023996272792990218,0.05382789527253775
Gayophytum eriospermum,0,3,3,1.0,1.0
Gayophytum heterozygum,0,1,1,1.0,1.0
Gayophytum humile,0,3,3,1.0,1.0
Gayophytum ramosissimum,0,4,4,1.0,0.9105509465652237
Geastrum quadrifidum,0,5,5,1.0,0.7760428250025136
Geastrum saccatum,0,1,1,1.0,1.0
Gelastocoris oculatus,3,2,5,0.02413002787627292,0.023975245305455268
Gemmabryum caespiticium,0,1,1,1.0,1.0
Genista monspessulana,17,7,24,6.64841942921259e-10,4.126546092558054e-14
Gentiana calycosa,0,113,113,4.636946414584933e-08,2.22506404670022e-05
Gentiana newberryi,2,143,145,8.459108075136758e-08,1.2668869704714924e-05
Gentianella amarella,0,7,7,0.6034645370398923,0.5813304975648097
Gentianopsis holopetala,3,81,84,0.0026735938840882194,0.007231055874192571
Gentianopsis simplex,0,28,28,0.02673836112705098,0.056309179680095994
Geopora cooperi,0,4,4,1.0,0.9105509465652237
Geopyxis carbonaria,6,67,73,0.18033028772625875,0.17594788411666476
Geopyxis deceptiva,0,1,1,1.0,1.0
Geopyxis rehmii,0,2,2,1.0,1.0
Geoscypha violacea,5,23,28,0.5898659840899363,0.8104259590832338
Geothlypis tolmiei,7,101,108,0.013698339558078858,0.02606825612711103
Geothlypis trichas,0,4,4,1.0,0.9105509465652237
Geranium caespitosum,0,1,1,1.0,1.0
Geranium californicum,5,21,26,0.4135949053791238,0.6815753903288135
Geranium carolinianum,1,1,2,0.2685730424867646,0.6723203844978234
Geranium dissectum,7,3,10,0.00010655132026942219,5.604574097560587e-06
Geranium macrorrhizum,0,1,1,1.0,1.0
Geranium molle,13,4,17,1.636154190509696e-08,4.5140865101110255e-12
Geranium purpureum,7,0,7,1.3315701680073362e-06,3.775277184632102e-09
Geranium richardsonii,3,155,158,9.976846023250456e-08,1.1764234044989279e-05
Geranium robertianum,2,1,3,0.056801432979852025,0.0803492820202322
Geranium sanguineum,0,1,1,1.0,1.0
Geum macrophyllum,0,90,90,1.3061347863847019e-06,0.0001739188468564851
Geum triflorum,0,27,27,0.025685714280551247,0.06225570614991151
Gilia brecciarum,2,4,6,0.21128172197002185,0.4637992200137968
Gilia capitata,21,53,74,0.0023370223566816562,0.001220070458488003
Gilia clokeyi,0,2,2,1.0,1.0
Gilia leptantha,14,12,26,3.0206229099851844e-06,5.733328500062187e-08
Gilia ophthalmoides,4,15,19,0.3433139456279959,0.6250673019802819
Gilia transmontana,0,2,2,1.0,1.0
Gilia tricolor,1,1,2,0.2685730424867646,0.6723203844978234
Gillmeria pallidactyla,0,1,1,1.0,1.0
Ginglymocladus discoidea,1,0,1,0.14476460320460613,0.3126936942061339
Githopsis pulchella,1,4,5,0.5424646889787644,1.0
Githopsis specularioides,2,2,4,0.10278607328810296,0.1906437976216683
Glaucidium californicum,0,1,1,1.0,1.0
Glaucidium gnoma,11,33,44,0.05416854884061152,0.07675270119704285
Glaucopsyche lygdamus,10,33,43,0.12454273491359846,0.1557236946800552
Glaucopsyche piasus,4,15,19,0.3433139456279959,0.6250673019802819
Glechoma hederacea,0,1,1,1.0,1.0
Glena nigricaria,0,3,3,1.0,1.0
Gliophorus laetus,0,1,1,1.0,1.0
Gliophorus psittacinus,1,1,2,0.2685730424867646,0.6723203844978234
Glischrochilus vittatus,0,2,2,1.0,1.0
Gloeophyllum carbonarium,1,0,1,0.14476460320460613,0.3126936942061339
Gloeophyllum sepiarium,4,3,7,0.0106471288054473,0.007559096939159896
Glossopetalon spinescens,1,1,2,0.2685730424867646,0.6723203844978234
Gloveria arizonensis,0,3,3,1.0,1.0
Gluphisia severa,0,3,3,1.0,1.0
Glyceria elata,0,1,1,1.0,1.0
Glycyrrhiza lepidota,0,1,1,1.0,1.0
Glyphipterix bifasciata,0,4,4,1.0,0.9105509465652237
Glyptoscelis illustris,1,0,1,0.14476460320460613,0.3126936942061339
Gnaphalium palustre,0,13,13,0.23752623411074927,0.27601031745794824
Gnathacmaeops pratensis,0,5,5,1.0,0.7760428250025136
Gnophaela latipennis,5,117,122,0.0004125407727743807,0.0017474135847055257
Gnorimoschema octomaculella,0,4,4,1.0,0.9105509465652237
Golovinomyces sordidus,0,1,1,1.0,1.0
Golubkovia trachyphylla,0,1,1,1.0,1.0
Gomphidius glutinosus,0,1,1,1.0,1.0
Gomphidius oregonensis,8,4,12,5.508489772806841e-05,2.266634219630844e-06
Gomphidius subroseus,15,17,32,1.2331102642256742e-05,7.127196323919477e-07
Gomphonema acuminatum,0,1,1,1.0,1.0
Gomphus clavatus,0,1,1,1.0,1.0
Gonidea angulata,0,1,1,1.0,1.0
Goodmania luteola,4,3,7,0.0106471288054473,0.007559096939159896
Goodyera oblongifolia,56,364,420,0.5784261377765636,0.5504414454673785
Gopherus agassizii,0,1,1,1.0,1.0
Gosodesmus claremontus,1,5,6,1.0,1.0
Graemeloweus iviei,18,16,34,1.631567877129474e-07,8.729532970903596e-10
Grammoptera militaris,0,1,1,1.0,1.0
Grammoptera subargentata,0,1,1,1.0,1.0
Graphephorum canescens,0,1,1,1.0,1.0
Graphocephala atropunctata,4,3,7,0.0106471288054473,0.007559096939159896
Graphocephala confluens,0,1,1,1.0,1.0
Graphopsocus cruciatus,0,2,2,1.0,1.0
Gratiola ebracteata,0,2,2,1.0,1.0
Gratiola neglecta,0,2,2,1.0,1.0
Grayia spinosa,2,9,11,0.6666373202113602,1.0
Greeneocharis circumscissa,4,13,17,0.29435365992578605,0.47386567178012184
Greya politella,3,1,4,0.010816792675262966,0.00633924523846032
Grindelia hirsutula,9,2,11,1.1607551894565098e-06,3.2337159071325644e-09
Grindelia squarrosa,0,9,9,0.37460992252836506,0.4468858706621094
Grus canadensis,1,17,18,0.5002083905620196,0.4588452058316618
Grylloblatta washoa,0,1,1,1.0,1.0
Gryllus saxatilis,0,1,1,1.0,1.0
Guepinia helvelloides,20,5,25,4.115676271684217e-13,1.7595077771308902e-19
Guepiniopsis alpina,3,98,101,0.00030237673561258455,0.001656422610604771
Gulo gulo,0,6,6,0.6025804396089913,0.6688993551184468
Gymnoclytia occidentalis,1,0,1,0.14476460320460613,0.3126936942061339
Gymnogyps californianus,3,3,6,0.0431068667335647,0.05837521372070738
Gymnopilus aurantiophyllus,3,2,5,0.02413002787627292,0.023975245305455268
Gymnopilus luteofolius,0,8,8,0.6124215574698968,0.5084255632839996
Gymnopilus punctifolius,0,1,1,1.0,1.0
Gymnopilus sapineus,3,0,3,0.0030335293929702875,0.000700171082788584
Gymnopilus ventricosus,2,14,16,1.0,1.0
Gymnopus androsaceus,2,0,2,0.0209561639230412,0.01499159650771353
Gymnopus dryophilus,25,4,29,1.3436026054327668e-17,8.651628499537057e-27
Gymnopus erythropus,0,1,1,1.0,1.0
Gymnorhinus cyanocephalus,1,24,25,0.2476906644158463,0.22836298286850215
Gymnosporangium amelanchieris,0,1,1,1.0,1.0
Gymnosteris parvula,0,2,2,1.0,1.0
Gymnotelium blasdaleanum,1,10,11,1.0,0.9368824658167821
Gyromitra californica,1,31,32,0.07681223748290478,0.11551429347859357
Gyromitra esculenta,10,11,21,0.000305085182763721,6.16180009236958e-05
Gyromitra infula,13,13,26,1.9697422449291458e-05,1.1186762763601503e-06
Gyromitra melaleucoides,0,2,2,1.0,1.0
Gyromitra splendida,0,1,1,1.0,1.0
Gyros muiri,0,6,6,0.6025804396089913,0.6688993551184468
Habrodais grunus,9,41,50,0.4259459685608713,0.6120171087678323
Habronattus americanus,0,30,30,0.016694385851981373,0.04613372038512279
Habronattus amicus,0,6,6,0.6025804396089913,0.6688993551184468
Habronattus hirsutus,0,9,9,0.37460992252836506,0.4468858706621094
Habronattus kubai,0,1,1,1.0,1.0
Habronattus oregonensis,1,7,8,1.0,1.0
Habropoda cineraria,1,0,1,0.14476460320460613,0.3126936942061339
Habropoda depressa,0,1,1,1.0,1.0
Hackelia brevicula,0,1,1,1.0,1.0
Hackelia californica,0,25,25,0.04095412181173697,0.07622457957144455
Hackelia micrantha,0,22,22,0.06301881478000051,0.10376364830846786
Hackelia mundula,1,197,198,1.902469712604988e-12,4.041639591274215e-08
Hackelia nervosa,0,22,22,0.06301881478000051,0.10376364830846786
Hackelia patens,0,1,1,1.0,1.0
Hackelia sharsmithii,0,1,1,1.0,1.0
Hackelia velutina,0,16,16,0.15161267346782015,0.19687992504129675
Hadena variolata,0,2,2,1.0,1.0
Hadromyia aldrichi,0,2,2,1.0,1.0
Haemorhous cassinii,2,266,268,1.0032045840550245e-15,2.8717373012357615e-10
Haemorhous mexicanus,58,33,91,8.390661273382605e-27,7.79144789437589e-40
Haemorhous purpureus,6,32,38,0.816840754862324,1.0
Halerpestes cymbalaria,4,1,5,0.0019413025415773043,0.00041787713651955216
Haliaeetus leucocephalus,8,91,99,0.08470874659091844,0.09568512255176692
Halictus farinosus,2,7,9,0.6270956953788205,0.8518628753529384
Halictus ligatus,1,0,1,0.14476460320460613,0.3126936942061339
Halictus rubicundus,2,2,4,0.10278607328810296,0.1906437976216683
Halictus tripartitus,0,3,3,1.0,1.0
Halimolobos jaegeri,2,2,4,0.10278607328810296,0.1906437976216683
Halmus chalybeus,0,1,1,1.0,1.0
Halyomorpha halys,1,0,1,0.14476460320460613,0.3126936942061339
Handkea lycoperdoides,0,2,2,1.0,1.0
Harmonia axyridis,11,1,12,6.080567969696642e-09,6.507654316294432e-13
Harmostes reflexulus,1,1,2,0.2685730424867646,0.6723203844978234
Harpaphe haydeniana,3,12,15,0.46864155961299403,0.8094879786929297
Harpaphe maurogona,1,2,3,0.3744588472376553,0.9141432822130974
Harrisina metallica,1,0,1,0.14476460320460613,0.3126936942061339
Hartmaniella sierrae,0,8,8,0.6124215574698968,0.5084255632839996
Hastingsia alba,0,10,10,0.3757244358299004,0.39438447212016514
Hebeloma alpinicola,0,2,2,1.0,1.0
Hebeloma crustuliniforme,2,0,2,0.0209561639230412,0.01499159650771353
Hebeloma hiemale,0,1,1,1.0,1.0
Hebeloma leucosarx,1,0,1,0.14476460320460613,0.3126936942061339
Hebeloma limbatum,1,0,1,0.14476460320460613,0.3126936942061339
Hebeloma sinapizans,1,0,1,0.14476460320460613,0.3126936942061339
Hecatera dysodea,1,0,1,0.14476460320460613,0.3126936942061339
Hedera helix,7,3,10,0.00010655132026942219,5.604574097560587e-06
Hedriodiscus binotatus,0,1,1,1.0,1.0
Hedwigia ciliata,1,0,1,0.14476460320460613,0.3126936942061339
Hedwigia detonsa,1,0,1,0.14476460320460613,0.3126936942061339
Hedya ochroleucana,0,1,1,1.0,1.0
Helenium bigelovii,13,250,263,1.0670248794631992e-06,1.638433934355091e-05
Helenium puberulum,1,0,1,0.14476460320460613,0.3126936942061339
Helianthella californica,2,35,37,0.1582152487866142,0.1819901968120017
Helianthus annuus,0,8,8,0.6124215574698968,0.5084255632839996
Helianthus californicus,0,1,1,1.0,1.0
Helicogloea compressa,1,0,1,0.14476460320460613,0.3126936942061339
Heliomeris multiflora,0,4,4,1.0,0.9105509465652237
Heliopetes ericetorum,5,27,32,0.8018949590094071,1.0
Heliothis belladonna,0,2,2,1.0,1.0
Heliothis oregonica,0,3,3,1.0,1.0
Heliothis phloxiphaga,1,32,33,0.07843551151890064,0.10491406255241775
Heliotropium curassavicum,0,2,2,1.0,1.0
Helminthoglypta cypreophila,6,2,8,0.00019772693610894856,1.2839299064071593e-05
Helminthoglypta euomphalodes,0,1,1,1.0,1.0
Helminthoglypta piutensis,1,0,1,0.14476460320460613,0.3126936942061339
Helodium blandowii,0,1,1,1.0,1.0
Helophilus fasciatus,1,0,1,0.14476460320460613,0.3126936942061339
Helophilus latifrons,0,8,8,0.6124215574698968,0.5084255632839996
Helvella acetabulum,2,2,4,0.10278607328810296,0.1906437976216683
Helvella compressa,0,1,1,1.0,1.0
Helvella dryophila,8,5,13,0.00012493599837919194,9.489826548441195e-06
Helvella vespertina,5,16,21,0.2153348364160998,0.36521497392958746
Hemaris thetis,7,18,25,0.07932486069508292,0.1015039674343699
Hemerobius stigma,0,1,1,1.0,1.0
Hemerocallis lilioasphodelus,0,1,1,1.0,1.0
Hemeroplanis historialis,2,2,4,0.10278607328810296,0.1906437976216683
Hemiargus ceraunus,0,1,1,1.0,1.0
Hemihyalea edwardsii,8,8,16,0.0008308440391289764,0.00023029611167632761
Hemileuca burnsi,1,0,1,0.14476460320460613,0.3126936942061339
Hemileuca eglanterina,2,109,111,9.614499053726385e-06,0.0002509810958939677
Hemileuca hera,0,6,6,0.6025804396089913,0.6688993551184468
Hemileuca nevadensis,0,1,1,1.0,1.0
Hemileuca nutalli,0,8,8,0.6124215574698968,0.5084255632839996
Hemipenthes jaennickeana,0,3,3,1.0,1.0
Hemipenthes sinuosus,1,13,14,0.7079821656760785,0.6890993041903317
Hemistropharia albocrenulata,0,1,1,1.0,1.0
Hemitomes congestum,1,2,3,0.3744588472376553,0.9141432822130974
Hemitrichia decipiens,0,4,4,1.0,0.9105509465652237
Hemitrichia montana,0,1,1,1.0,1.0
Hemizonella minima,2,59,61,0.009495805792595867,0.021224643877609865
Henningsomyces candidus,1,5,6,1.0,1.0
Heracleum maximum,8,377,385,1.253947129149176e-16,7.477900329953797e-12
Hericium abietis,1,0,1,0.14476460320460613,0.3126936942061339
Hericium coralloides,7,0,7,1.3315701680073362e-06,3.775277184632102e-09
Hericium erinaceus,34,17,51,3.222929241938953e-17,2.615620770319851e-25
Hermanssonia centrifuga,0,1,1,1.0,1.0
Hermetia illucens,3,3,6,0.0431068667335647,0.05837521372070738
Herniaria hirsuta,1,0,1,0.14476460320460613,0.3126936942061339
Herpyllus propinquus,7,3,10,0.00010655132026942219,5.604574097560587e-06
Hesperapis regularis,1,0,1,0.14476460320460613,0.3126936942061339
Hesperia comma,0,9,9,0.37460992252836506,0.4468858706621094
Hesperia harpalus,0,4,4,1.0,0.9105509465652237
Hesperia juba,3,26,29,0.7908280788933808,0.7125101212946094
Hesperia nevada,0,3,3,1.0,1.0
Hesperia uncas,0,2,2,1.0,1.0
Hesperiphona vespertina,1,135,136,2.6147382510244255e-08,9.252291818472961e-06
Hesperis matronalis,9,4,13,1.1427959821928325e-05,1.820984079580061e-07
Hesperochiron californicus,2,36,38,0.16129779019077917,0.16644259216844146
Hesperochiron pumilus,1,23,24,0.24143280901572373,0.25202843593319213
Hesperoleucus symmetricus,0,2,2,1.0,1.0
Hesperolinon micranthum,1,1,2,0.2685730424867646,0.6723203844978234
Hesperonemastoma modestum,0,3,3,1.0,1.0
Hesperostipa comata,2,12,14,1.0,1.0
Hesperotettix viridis,1,0,1,0.14476460320460613,0.3126936942061339
Hesperoyucca whipplei,5,1,6,0.00033535930364562256,2.5155693289996723e-05
Hesperumia latipennis,0,1,1,1.0,1.0
Hesperumia sulphuraria,1,40,41,0.02421393884327443,0.048973319116519747
Hetaerina americana,2,2,4,0.10278607328810296,0.1906437976216683
Heterobasidion occidentale,0,1,1,1.0,1.0
Heterocodon rariflorum,3,19,22,1.0,1.0
Heteroecus pacificus,11,62,73,0.8677445911547119,1.0
Heteromeles arbutifolia,124,15,139,3.204699726154688e-86,3.6423138344804366e-137
Heteroplectron californicum,0,1,1,1.0,1.0
Heterosilpha ramosa,0,3,3,1.0,1.0
Heterotheca orovillosa,0,12,12,0.2360424886052977,0.31009055076592434
Heuchera micrantha,29,27,56,5.7674166585759796e-11,9.481916750202516e-15
Heuchera parvifolia,0,5,5,1.0,0.7760428250025136
Heuchera rubescens,5,85,90,0.015276417217726962,0.02407352277029501
Hexagenia limbata,0,1,1,1.0,1.0
Heyderia abietis,6,3,9,0.0005200289628174682,7.003163864249939e-05
Hieracium albiflorum,27,259,286,0.014449107664283804,0.019384087941075878
Hieracium horridum,4,158,162,4.876444543916993e-07,2.3009284454618022e-05
Hilaria jamesii,1,1,2,0.2685730424867646,0.6723203844978234
Himantopus mexicanus,1,0,1,0.14476460320460613,0.3126936942061339
Hippodamia apicalis,0,5,5,1.0,0.7760428250025136
Hippodamia convergens,121,451,572,1.6679473821110095e-05,7.265111507566296e-06
Hippodamia glacialis,0,4,4,1.0,0.9105509465652237
Hippodamia sinuata,1,1,2,0.2685730424867646,0.6723203844978234
Hippuris vulgaris,0,7,7,0.6034645370398923,0.5813304975648097
Hirschfeldia incana,1,2,3,0.3744588472376553,0.9141432822130974
Hirundo rustica,3,13,16,0.7183433205274137,0.8961140145401856
Histrionicus histrionicus,0,1,1,1.0,1.0
Hohenbuehelia angustata,0,1,1,1.0,1.0
Hohenbuehelia auriscalpium,0,1,1,1.0,1.0
Hohenbuehelia petaloides,2,1,3,0.056801432979852025,0.0803492820202322
Hoita macrostachya,10,0,10,4.0368220512681146e-09,4.586479508074135e-13
Hoita orbicularis,7,2,9,3.65759227530616e-05,8.499366410736652e-07
Holcostethus tristis,0,2,2,1.0,1.0
Holcus lanatus,5,4,9,0.004804892843884087,0.0024551155675152643
Holocarpha heermannii,3,1,4,0.010816792675262966,0.00633924523846032
Holocarpha virgata,1,0,1,0.14476460320460613,0.3126936942061339
Holocnemus pluchei,2,2,4,0.10278607328810296,0.1906437976216683
Holodiscus discolor,5,152,157,6.211863167061708e-06,9.261346257594749e-05
Holopleura marginata,0,1,1,1.0,1.0
Holorusia hespera,14,28,42,0.001688859206898724,0.0011371066562158886
Homaemus aeneifrons,1,0,1,0.14476460320460613,0.3126936942061339
Homaemus parvulus,0,1,1,1.0,1.0
Homalothecium nuttallii,0,1,1,1.0,1.0
Homoeosoma impressalis,0,1,1,1.0,1.0
Homophron spadiceum,0,2,2,1.0,1.0
Hoplia callipyge,0,1,1,1.0,1.0
Hoplia dispar,2,5,7,0.2688137426846044,0.6011437582684053
Hoplisoides hamatus,1,0,1,0.14476460320460613,0.3126936942061339
Hoplitis fulgida,0,4,4,1.0,0.9105509465652237
Hordeum brachyantherum,0,8,8,0.6124215574698968,0.5084255632839996
Hordeum californicum,0,1,1,1.0,1.0
Hordeum jubatum,0,3,3,1.0,1.0
Hordeum murinum,5,2,7,0.0010327341762908842,0.00018014051424031924
Hornungia procumbens,0,1,1,1.0,1.0
Hosackia crassifolia,22,248,270,0.0023233123916905074,0.004095093467432929
Hosackia incana,4,10,14,0.1328770537680288,0.26309932517491896
Hosackia oblongifolia,27,436,463,6.139598752609814e-09,1.72560146999374e-07
Hosackia pinnata,1,6,7,1.0,1.0
Hosackia stipularis,0,2,2,1.0,1.0
Hulsea algida,0,14,14,0.24486350799097997,0.24618548812479032
Hulsea brevifolia,1,20,21,0.3485544901265487,0.3394968187912247
Hulsea heterochroma,0,13,13,0.23752623411074927,0.27601031745794824
Hulsea vestita,0,7,7,0.6034645370398923,0.5813304975648097
Hulstina imitatrix,0,1,1,1.0,1.0
Humulus lupulus,0,3,3,1.0,1.0
Hyacinthus orientalis,0,5,5,1.0,0.7760428250025136
Hyalophora euryalus,29,110,139,0.039576240999417214,0.04336128334694056
Hyalophora gloveri,1,2,3,0.3744588472376553,0.9141432822130974
Hyalopterus pruni,1,0,1,0.14476460320460613,0.3126936942061339
Hydatostega viridiflos,0,1,1,1.0,1.0
Hydnellum aurantiacum,0,1,1,1.0,1.0
Hydnellum fuscoindicum,1,0,1,0.14476460320460613,0.3126936942061339
Hydnellum peckii,0,1,1,1.0,1.0
Hydnotrya cerebriformis,0,1,1,1.0,1.0
Hydnotrya variiformis,0,1,1,1.0,1.0
Hydnum repandum,0,2,2,1.0,1.0
Hydra oligactis,0,1,1,1.0,1.0
Hydriomena albifasciata,1,0,1,0.14476460320460613,0.3126936942061339
Hydriomena nubilofasciata,3,1,4,0.010816792675262966,0.00633924523846032
Hydromantes brunus,0,3,3,1.0,1.0
Hydromantes platycephalus,2,18,20,0.7576902520422768,0.8016454378630772
Hydrophilus triangularis,3,7,10,0.16639035724257725,0.3442511672283348
Hydrophyllum alpestre,0,116,116,3.1095405710989796e-08,1.7042527075228125e-05
Hydrophyllum capitatum,0,1,1,1.0,1.0
Hydrophyllum occidentale,19,56,75,0.01266680695309354,0.01212293191983239
Hydropus pseudotenax,0,2,2,1.0,1.0
Hygrocybe acutoconica,0,2,2,1.0,1.0
Hygrocybe reidii,0,1,1,1.0,1.0
Hygrocybe singeri,4,5,9,0.030121806187693938,0.03739180706614353
Hygrophoropsis aurantiaca,11,11,22,8.694688474758711e-05,9.308055009992914e-06
Hygrophorus caeruleus,0,4,4,1.0,0.9105509465652237
Hygrophorus chrysodon,3,3,6,0.0431068667335647,0.05837521372070738
Hygrophorus eburneus,22,2,24,6.968430549416257e-17,1.3504480772389785e-25
Hygrophorus erubescens,0,2,2,1.0,1.0
Hygrophorus goetzei,0,4,4,1.0,0.9105509465652237
Hygrophorus graveolens,0,1,1,1.0,1.0
Hygrophorus hypothejus,2,3,5,0.15522343689242213,0.32387652224382535
Hygrophorus ligatus,0,11,11,0.38449278358904854,0.3492157200022511
Hygrophorus marzuolus,0,2,2,1.0,1.0
Hygrophorus purpurascens,1,28,29,0.11239699011005075,0.15442870300712783
Hygrophorus roseobrunneus,1,0,1,0.14476460320460613,0.3126936942061339
Hygrophorus russula,6,1,7,5.640935459925577e-05,1.4388133744720056e-06
Hygrophorus siccipes,5,4,9,0.004804892843884087,0.0024551155675152643
Hygrophorus subalpinus,0,25,25,0.04095412181173697,0.07622457957144455
Hylaeus basalis,0,1,1,1.0,1.0
Hylaeus rudbeckiae,0,1,1,1.0,1.0
Hylephila phyleus,1,2,3,0.3744588472376553,0.9141432822130974
Hyles lineata,53,405,458,0.0835714368488854,0.08873945260487648
Hymenopappus filifolius,0,8,8,0.6124215574698968,0.5084255632839996
Hymenoscyphus repandus,0,1,1,1.0,1.0
Hymenoxys cooperi,3,3,6,0.0431068667335647,0.05837521372070738
Hymenoxys hoopesii,0,14,14,0.24486350799097997,0.24618548812479032
Hypena abalienalis,0,1,1,1.0,1.0
Hypena humuli,0,1,1,1.0,1.0
Hyperaspis taeniata,1,0,1,0.14476460320460613,0.3126936942061339
Hypercompe permaculata,1,2,3,0.3744588472376553,0.9141432822130974
Hypericum anagalloides,1,96,97,7.971830222432095e-06,0.00029450152092648486
Hypericum calycinum,17,15,32,3.377715863365957e-07,2.480281437315814e-09
Hypericum concinnum,13,5,18,5.1012562678773784e-08,3.3993804082578516e-11
Hypericum perforatum,28,44,72,3.2519530899013477e-07,1.0608654711704169e-08
Hypericum scouleri,2,49,51,0.0275275077506787,0.05195651041345731
Hyphantria cunea,4,12,16,0.2740043737810785,0.40028983280731434
Hypholoma capnoides,2,3,5,0.15522343689242213,0.32387652224382535
Hypholoma fasciculare,31,44,75,1.4350846469997042e-08,1.1385956760796136e-10
Hypholoma marginatum,1,0,1,0.14476460320460613,0.3126936942061339
Hypochaeris glabra,4,1,5,0.0019413025415773043,0.00041787713651955216
Hypochaeris radicata,3,0,3,0.0030335293929702875,0.000700171082788584
Hypochilus petrunkevitchi,0,2,2,1.0,1.0
Hypocritanus lemur,0,1,1,1.0,1.0
Hypogymnia imshaugii,2,6,8,0.3262180684327187,0.7311980927864552
Hypomyces aurantius,1,0,1,0.14476460320460613,0.3126936942061339
Hypomyces cervinus,3,1,4,0.010816792675262966,0.00633924523846032
Hypomyces lateritius,1,0,1,0.14476460320460613,0.3126936942061339
Hypomyces microspermus,0,1,1,1.0,1.0
Hypomyces rosellus,1,1,2,0.2685730424867646,0.6723203844978234
Hypoponera punctatissima,1,0,1,0.14476460320460613,0.3126936942061339
Hypopta ethela,0,1,1,1.0,1.0
Hypsalonia miwoki,0,1,1,1.0,1.0
Hypsalonia rentzi,0,1,1,1.0,1.0
Hypsiglena ochrorhynchus,2,1,3,0.056801432979852025,0.0803492820202322
Hysterangium coriaceum,0,1,1,1.0,1.0
Iberis sempervirens,0,1,1,1.0,1.0
Icaricia acmon,23,70,93,0.007702516673916747,0.007725760522903564
Icaricia icarioides,7,180,187,3.1660894273425824e-06,4.7147767328446335e-05
Icaricia lupini,1,43,44,0.01643618076915838,0.036921759051915914
Icaricia saepiolus,6,222,228,2.5286567211926076e-09,5.981345139138872e-07
Icaricia shasta,0,36,36,0.007132175646578675,0.02562119468214464
Icteria virens,2,1,3,0.056801432979852025,0.0803492820202322
Icterus bullockii,3,10,13,0.41916983303031286,0.626122924488651
Icterus cucullatus,3,2,5,0.02413002787627292,0.023975245305455268
Icterus parisorum,1,2,3,0.3744588472376553,0.9141432822130974
Icterus spurius,0,1,1,1.0,1.0
Idahoa scapigera,0,3,3,1.0,1.0
Idia americalis,2,1,3,0.056801432979852025,0.0803492820202322
Idia lubricalis,1,0,1,0.14476460320460613,0.3126936942061339
Idia suffusalis,0,1,1,1.0,1.0
Idionotus incurvus,1,0,1,0.14476460320460613,0.3126936942061339
Idionotus tehachapi,3,0,3,0.0030335293929702875,0.000700171082788584
Idionotus tuolumne,2,1,3,0.056801432979852025,0.0803492820202322
Idiostatus aberrans,2,9,11,0.6666373202113602,1.0
Idiostatus aequalis,1,0,1,0.14476460320460613,0.3126936942061339
Idiostatus inermis,0,3,3,1.0,1.0
Iflavirus dinococcinellae,0,1,1,1.0,1.0
Ilex aquifolium,2,2,4,0.10278607328810296,0.1906437976216683
Imbribryum alpinum,0,1,1,1.0,1.0
Impatiens glandulifera,0,1,1,1.0,1.0
Incisalia eryphon,2,90,92,0.00014832041709750336,0.0013448901735602008
Incisalia irioides,3,55,58,0.040026200636531103,0.0676306243271266
Infundibulicybe gibba,0,3,3,1.0,1.0
Infundibulicybe squamulosa,1,19,20,0.3447987554750399,0.37521694522958526
Inocutis dryophila,0,1,1,1.0,1.0
Inocybe bufonia,0,1,1,1.0,1.0
Inocybe catalaunica,0,1,1,1.0,1.0
Inocybe chelanensis,0,1,1,1.0,1.0
Inocybe geophylla,1,2,3,0.3744588472376553,0.9141432822130974
Inocybe giacomi,0,1,1,1.0,1.0
Inocybe lacera,0,5,5,1.0,0.7760428250025136
Inocybe moravica,0,2,2,1.0,1.0
Inocybe multifolia,0,1,1,1.0,1.0
Inocybe pallidicremea,0,3,3,1.0,1.0
Inocybe phaeocystidiosa,0,3,3,1.0,1.0
Inocybe pseudoscabelliformis,0,1,1,1.0,1.0
Inocybe sindonia,0,1,1,1.0,1.0
Inocybe whitei,1,0,1,0.14476460320460613,0.3126936942061339
Inonotus hispidus,0,1,1,1.0,1.0
Ionactis alpina,0,1,1,1.0,1.0
Iphthiminus lewisii,0,2,2,1.0,1.0
Iphthiminus serratus,0,20,20,0.10203106758234803,0.12794167189413608
Ipomopsis aggregata,4,605,609,3.0526231858137815e-35,4.929939808129091e-22
Ipomopsis congesta,0,24,24,0.03967208129449859,0.08442030606095953
Ipomopsis polycladon,0,1,1,1.0,1.0
Ipomopsis tenuituba,0,45,45,0.002047706949002647,0.010822851941581078
Iris florentina,1,0,1,0.14476460320460613,0.3126936942061339
Iris germanica,1,1,2,0.2685730424867646,0.6723203844978234
Iris hartwegii,145,609,754,0.0003364417184323078,0.00024689138241425863
Iris hybrida,1,3,4,0.4650164385481151,1.0
Iris macrosiphon,57,0,57,1.3709510593690214e-48,9.779253501828346e-74
Iris missouriensis,4,160,164,3.309091555938932e-07,1.9381634795511593e-05
Iris munzii,1,5,6,1.0,1.0
Iris pseudacorus,4,9,13,0.10658251785953915,0.20215021085988086
Iris reticulata,1,0,1,0.14476460320460613,0.3126936942061339
Iris sanguinea,0,1,1,1.0,1.0
Iris tenuissima,1,1,2,0.2685730424867646,0.6723203844978234
Isatis tinctoria,0,1,1,1.0,1.0
Ischnura cervula,7,35,42,0.6605915730682217,0.8538931756842731
Ischnura perparva,3,12,15,0.46864155961299403,0.8094879786929297
Isodontia elegans,1,1,2,0.2685730424867646,0.6723203844978234
Isodontia philadelphica,2,0,2,0.0209561639230412,0.01499159650771353
Isoetes bolanderi,0,4,4,1.0,0.9105509465652237
Isoetes nuttallii,1,0,1,0.14476460320460613,0.3126936942061339
Isoetes orcuttii,4,1,5,0.0019413025415773043,0.00041787713651955216
Isolepis setacea,1,1,2,0.2685730424867646,0.6723203844978234
Isotrema californicum,47,1,48,1.419210945340853e-38,3.288143781930692e-59
Ixodes pacificus,9,5,14,2.785639213432983e-05,8.786751400281266e-07
Ixoreus naevius,13,14,27,3.2941979093487867e-05,2.610230905713789e-06
Jadera haematoloma,2,0,2,0.0209561639230412,0.01499159650771353
Jahnoporus hirtus,2,3,5,0.15522343689242213,0.32387652224382535
Jalysus wickhami,0,1,1,1.0,1.0
Jamesia americana,2,20,22,0.7605811964984595,0.6781643221724958
Jensia rammii,2,7,9,0.6270956953788205,0.8518628753529384
Jensia yosemitana,0,3,3,1.0,1.0
Jepsonia heterandra,2,1,3,0.056801432979852025,0.0803492820202322
Judolia instabilis,0,26,26,0.025555133894118995,0.0688671495635685
Judolia montivagans,0,1,1,1.0,1.0
Juga douglasi,1,1,2,0.2685730424867646,0.6723203844978234
Juglans hindsii,3,0,3,0.0030335293929702875,0.000700171082788584
Junco hyemalis,91,757,848,0.0014599784864044187,0.00223246363984132
Juncus balticus,0,3,3,1.0,1.0
Juncus bufonius,2,0,2,0.0209561639230412,0.01499159650771353
Juncus chlorocephalus,0,35,35,0.0069115977543475066,0.028234654159491945
Juncus confusus,0,1,1,1.0,1.0
Juncus digitatus,1,1,2,0.2685730424867646,0.6723203844978234
Juncus effusus,1,5,6,1.0,1.0
Juncus ensifolius,0,3,3,1.0,1.0
Juncus mertensianus,0,1,1,1.0,1.0
Juncus orthophyllus,0,2,2,1.0,1.0
Juncus oxymeris,0,1,1,1.0,1.0
Juncus parryi,0,7,7,0.6034645370398923,0.5813304975648097
Juncus xiphioides,0,2,2,1.0,1.0
Juniperus californica,6,0,6,9.199825086801498e-06,7.715317253706965e-08
Juniperus communis,0,16,16,0.15161267346782015,0.19687992504129675
Juniperus occidentalis,18,740,758,6.56207614606341e-30,3.88650844364996e-21
Juniperus osteosperma,9,69,78,0.6280199143196832,0.5641735742520264
Junonia grisea,17,68,85,0.16325704613249442,0.19586252649616584
Kalmia microphylla,0,105,105,1.6837708977320826e-07,4.537856777246827e-05
Keckiella breviflora,31,84,115,0.00046394436837282,0.00024053656113570972
Keckiella lemmonii,1,37,38,0.03563497956271764,0.06506592507691755
Keckiella rothrockii,1,13,14,0.7079821656760785,0.6890993041903317
Keckiella ternata,1,0,1,0.14476460320460613,0.3126936942061339
Kelloggia galioides,4,302,306,7.751726465857515e-16,9.74407663775148e-11
Kibramoa suprenans,0,1,1,1.0,1.0
Kickxia elatine,1,0,1,0.14476460320460613,0.3126936942061339
Kindbergia praelonga,0,1,1,1.0,1.0
Kniphofia uvaria,1,0,1,0.14476460320460613,0.3126936942061339
Koeleria macrantha,0,13,13,0.23752623411074927,0.27601031745794824
Koeleria spicata,0,3,3,1.0,1.0
Koenigia davisiae,0,55,55,0.00034479197657101866,0.00423664133394264
Koenigia phytolaccifolia,0,57,57,0.00021966229870961306,0.0035185750074501754
Kopsiopsis strobilacea,1,7,8,1.0,1.0
Kuehneromyces mutabilis,0,1,1,1.0,1.0
Kuehneromyces obscurus,0,2,2,1.0,1.0
Kumlienia hystricula,14,16,30,2.562317441634281e-05,2.0165405383320017e-06
Kyhosia bolanderi,0,43,43,0.00188367039695229,0.013084970189199272
Lacanobia subjuncta,0,3,3,1.0,1.0
Laccaria amethysteo-occidentalis,26,8,34,8.152678534427419e-16,1.1182973942742057e-23
Laccaria bicolor,1,0,1,0.14476460320460613,0.3126936942061339
Laccaria laccata,0,1,1,1.0,1.0
Laccaria proxima,1,0,1,0.14476460320460613,0.3126936942061339
Laccaria pumila,0,2,2,1.0,1.0
Lachnellula arida,0,6,6,0.6025804396089913,0.6688993551184468
Lachnellula calyciformis,0,1,1,1.0,1.0
Lachnum virgineum,0,3,3,1.0,1.0
Lacinipolia davena,0,3,3,1.0,1.0
Lactarius alnicola,3,2,5,0.02413002787627292,0.023975245305455268
Lactarius alpinus,0,3,3,1.0,1.0
Lactarius argillaceifolius,8,1,9,1.5113716238966603e-06,4.3344519411722725e-09
Lactarius caespitosus,0,2,2,1.0,1.0
Lactarius californiensis,4,1,5,0.0019413025415773043,0.00041787713651955216
Lactarius crassus,0,1,1,1.0,1.0
Lactarius deliciosus,6,10,16,0.01998743371112142,0.02368705911568066
Lactarius montanus,0,2,2,1.0,1.0
Lactarius occidentalis,0,1,1,1.0,1.0
Lactarius pseudomucidus,0,1,1,1.0,1.0
Lactarius repraesentaneus,0,1,1,1.0,1.0
Lactarius resimus,1,0,1,0.14476460320460613,0.3126936942061339
Lactarius riparius,0,1,1,1.0,1.0
Lactarius rubidus,3,2,5,0.02413002787627292,0.023975245305455268
Lactarius rubrilacteus,16,9,25,2.0346146520432093e-08,1.4426908053107e-11
Lactarius rubriviridis,0,1,1,1.0,1.0
Lactarius scrobiculatus,0,3,3,1.0,1.0
Lactarius sphagneti,0,2,2,1.0,1.0
Lactarius xanthogalactus,13,7,20,3.4632594883488514e-07,1.0342272224237015e-09
Lactuca serriola,7,35,42,0.6605915730682217,0.8538931756842731
Lactuca virosa,0,6,6,0.6025804396089913,0.6688993551184468
Ladona julia,0,52,52,0.0005244679655933337,0.005603592816712951
Laemophloeus shastanus,0,1,1,1.0,1.0
Laemostenus complanatus,0,1,1,1.0,1.0
Laetiporus conifericola,3,229,232,3.6318053102501553e-12,1.9447281787351094e-08
Laetiporus gilbertsonii,18,45,63,0.0034920519039813723,0.0026913035316802137
Lagophylla glandulosa,3,0,3,0.0030335293929702875,0.000700171082788584
Lagophylla ramosissima,2,0,2,0.0209561639230412,0.01499159650771353
Lagopus leucura,0,4,4,1.0,0.9105509465652237
Lamium amplexicaule,18,9,27,9.67628910016274e-10,1.0517141433902147e-13
Lamium galeobdolon,0,1,1,1.0,1.0
Lamium maculatum,0,2,2,1.0,1.0
Lamium purpureum,3,1,4,0.010816792675262966,0.00633924523846032
Lamproderma arcyrioides,0,2,2,1.0,1.0
Lamproderma maculatum,0,1,1,1.0,1.0
Lamproderma pulveratum,0,1,1,1.0,1.0
Lamproderma sauteri,0,1,1,1.0,1.0
Lampropeltis californiae,12,5,17,2.5580251860206734e-07,4.6419311224882447e-10
Lampropeltis zonata,7,93,100,0.03219645613221221,0.04734280765590718
Langermannia pachyderma,0,1,1,1.0,1.0
Lanius borealis,0,1,1,1.0,1.0
Lanius ludovicianus,1,2,3,0.3744588472376553,0.9141432822130974
Laphamia megalocephala,0,5,5,1.0,0.7760428250025136
Laphria aimatis,1,0,1,0.14476460320460613,0.3126936942061339
Laphria asackeni,0,1,1,1.0,1.0
Laphria astur,0,4,4,1.0,0.9105509465652237
Laphria felis,0,1,1,1.0,1.0
Laphria fernaldi,0,1,1,1.0,1.0
Laphria franciscana,3,10,13,0.41916983303031286,0.626122924488651
Laphria sadales,0,1,1,1.0,1.0
Laphria vultur,0,1,1,1.0,1.0
Lapposyrphus lapponicus,4,31,35,0.810629962857985,0.7853996420117839
Lappula occidentalis,1,0,1,0.14476460320460613,0.3126936942061339
Lapsana communis,11,11,22,8.694688474758711e-05,9.308055009992914e-06
Largus californicus,8,5,13,0.00012493599837919194,9.489826548441195e-06
Larinus curtus,0,1,1,1.0,1.0
Larinus villosus,0,1,1,1.0,1.0
Larus argentatus,0,1,1,1.0,1.0
Larus californicus,0,28,28,0.02673836112705098,0.056309179680095994
Lasconotus subcostulatus,1,0,1,0.14476460320460613,0.3126936942061339
Lasconotus vegrandis,0,1,1,1.0,1.0
Lasioglossum ovaliceps,2,3,5,0.15522343689242213,0.32387652224382535
Lasionycteris noctivagans,2,5,7,0.2688137426846044,0.6011437582684053
Lasiurus frantzii,0,1,1,1.0,1.0
Lasius pallitarsis,0,1,1,1.0,1.0
Lasthenia gracilis,0,1,1,1.0,1.0
Lathyrus brownii,0,1,1,1.0,1.0
Lathyrus jepsonii,0,3,3,1.0,1.0
Lathyrus lanszwertii,0,14,14,0.24486350799097997,0.24618548812479032
Lathyrus latifolius,118,181,299,3.328895229037894e-26,2.8480695274007397e-34
Lathyrus nevadensis,29,37,66,7.829697866382026e-09,3.3847866947483176e-11
Lathyrus oleraceus,0,1,1,1.0,1.0
Lathyrus sphaericus,3,3,6,0.0431068667335647,0.05837521372070738
Lathyrus sulphureus,98,89,187,4.921573493735051e-34,1.4695770785748067e-48
Lathyrus tingitanus,13,1,14,1.482714690352632e-10,1.7858865074142794e-15
Latrodectus geometricus,2,0,2,0.0209561639230412,0.01499159650771353
Latrodectus hesperus,10,28,38,0.059597340814055,0.06520761455191267
Layia glandulosa,12,24,36,0.0035441984900255793,0.0028926157257363663
Layia heterotricha,1,0,1,0.14476460320460613,0.3126936942061339
Layia pentachaeta,3,0,3,0.0030335293929702875,0.000700171082788584
Layia platyglossa,1,1,2,0.2685730424867646,0.6723203844978234
Lecanora gangaleoides,0,1,1,1.0,1.0
Lecanora hybocarpa,0,2,2,1.0,1.0
Lecanora pseudomellea,0,5,5,1.0,0.7760428250025136
Leccinum californicum,0,6,6,0.6025804396089913,0.6688993551184468
Leccinum insigne,0,4,4,1.0,0.9105509465652237
Leccinum manzanitae,1,3,4,0.4650164385481151,1.0
Lecidea atrobrunnea,0,2,2,1.0,1.0
Lecidea tessellata,0,1,1,1.0,1.0
Leconectes striatellus,1,3,4,0.4650164385481151,1.0
Legaliana badia,0,1,1,1.0,1.0
Leiothlypis celata,13,77,90,1.0,1.0
Leiothlypis peregrina,0,1,1,1.0,1.0
Leiothlypis ruficapilla,2,85,87,0.00032812802939583355,0.0020949245399314634
Leiothlypis virginiae,0,2,2,1.0,1.0
Lemanea fluviatilis,0,1,1,1.0,1.0
Lemna minor,0,6,6,0.6025804396089913,0.6688993551184468
Lemna trisulca,1,0,1,0.14476460320460613,0.3126936942061339
Lentinellus montanus,0,2,2,1.0,1.0
Lentinellus ursinus,0,2,2,1.0,1.0
Lentinus brumalis,1,2,3,0.3744588472376553,0.9141432822130974
Lenzites betulinus,24,3,27,1.3295119091968692e-17,8.550035887219845e-27
Leocarpus fragilis,19,14,33,1.1672617598426109e-08,1.1241077610986228e-11
Leotia lubrica,1,1,2,0.2685730424867646,0.6723203844978234
Lepechinia calycina,1,0,1,0.14476460320460613,0.3126936942061339
Lepidium campestre,10,18,28,0.004320407145356672,0.003438853520610955
Lepidium densiflorum,0,4,4,1.0,0.9105509465652237
Lepidium flavum,0,1,1,1.0,1.0
Lepidium heterophyllum,0,2,2,1.0,1.0
Lepidium lasiocarpum,0,2,2,1.0,1.0
Lepidium latifolium,0,4,4,1.0,0.9105509465652237
Lepidium nitidum,3,0,3,0.0030335293929702875,0.000700171082788584
Lepidium perfoliatum,0,1,1,1.0,1.0
Lepidium virginicum,0,4,4,1.0,0.9105509465652237
Lepidosaphes ulmi,1,0,1,0.14476460320460613,0.3126936942061339
Lepiota atrodisca,3,1,4,0.010816792675262966,0.00633924523846032
Lepiota flammeotincta,3,2,5,0.02413002787627292,0.023975245305455268
Lepiota magnispora,5,10,15,0.054168072376255025,0.08749703983642151
Lepiota spheniscispora,1,0,1,0.14476460320460613,0.3126936942061339
Lepomis cyanellus,4,4,8,0.01886984470142184,0.01861366248431812
Lepomis macrochirus,4,7,11,0.06219290144309395,0.10212099408086615
Lepraria membranacea,1,0,1,0.14476460320460613,0.3126936942061339
Leptarctia californiae,1,18,19,0.5081076590495464,0.41485136099373987
Leptobryum pyriforme,0,1,1,1.0,1.0
Leptochidium albociliatum,0,1,1,1.0,1.0
Leptoglossus clypealis,4,3,7,0.0106471288054473,0.007559096939159896
Leptoglossus occidentalis,17,54,71,0.028483907507462967,0.0358286751049452
Leptomantispa pulchella,0,4,4,1.0,0.9105509465652237
Leptoporus mollis,2,1,3,0.056801432979852025,0.0803492820202322
Leptosiphon bicolor,12,3,15,2.503062211953165e-08,7.616804796649087e-12
Leptosiphon bolanderi,0,1,1,1.0,1.0
Leptosiphon chrysanthus,9,0,9,2.7892926019110602e-08,9.215270667313031e-12
Leptosiphon ciliatus,21,666,687,1.5940618413361095e-23,2.5143388647940628e-17
Leptosiphon filipes,2,3,5,0.15522343689242213,0.32387652224382535
Leptosiphon montanus,9,5,14,2.785639213432983e-05,8.786751400281266e-07
Leptosiphon nudatus,8,2,10,6.5864666725043825e-06,5.342167245405184e-08
Leptosiphon nuttallii,9,78,87,0.3591155806583479,0.345632454933554
Leptosiphon oblanceolatus,1,4,5,0.5424646889787644,1.0
Leptosiphon pachyphyllus,0,2,2,1.0,1.0
Leptosiphon parviflorus,1,0,1,0.14476460320460613,0.3126936942061339
Leptosiphon septentrionalis,0,1,1,1.0,1.0
Leptosiphon serrulatus,0,1,1,1.0,1.0
Leptostales rubromarginaria,0,1,1,1.0,1.0
Leptotes marina,1,29,30,0.11442317027725885,0.1401452618300091
Leptothorax calderoni,0,1,1,1.0,1.0
Leptothorax nevadensis,0,2,2,1.0,1.0
Leptothorax nitens,0,1,1,1.0,1.0
Leptothorax rugatulus,0,1,1,1.0,1.0
Leptura hovorei,1,1,2,0.2685730424867646,0.6723203844978234
Leptura sequoiae,0,1,1,1.0,1.0
Lepturopsis dolorosa,0,6,6,0.6025804396089913,0.6688993551184468
Lepus americanus,0,36,36,0.007132175646578675,0.02562119468214464
Lepus californicus,77,50,127,6.741860946409072e-33,1.1528406358189915e-48
Lepus townsendii,0,28,28,0.02673836112705098,0.056309179680095994
Leratiomyces cucullatus,0,1,1,1.0,1.0
Leratiomyces percevalii,5,22,27,0.5806279452021227,0.7463457831414091
Lessingia leptoclada,12,56,68,0.488552207724265,0.5681134462129436
Lessingia nemaclada,1,0,1,0.14476460320460613,0.3126936942061339
Lessingia pectinata,1,0,1,0.14476460320460613,0.3126936942061339
Lestes congener,2,11,13,1.0,1.0
Lestes disjunctus,0,17,17,0.15747128520432685,0.17645428752866515
Lestes dryas,0,39,39,0.0046877939621657125,0.019179555698833974
Lestes stultus,0,2,2,1.0,1.0
Lestes unguiculatus,0,1,1,1.0,1.0
Letharia columbiana,18,243,261,0.00020049795852929348,0.0006874600076911702
Letharia lupina,0,4,4,1.0,0.9105509465652237
Letharia vulpina,19,431,450,2.1976314669598002e-12,9.236113749164667e-10
Lethocerus americanus,0,14,14,0.24486350799097997,0.24618548812479032
Leucanthemum maximum,0,2,2,1.0,1.0
Leucanthemum vulgare,2,13,15,1.0,1.0
Leucoagaricus americanus,4,0,4,0.00043910829886184923,3.314336839661014e-05
Leucoagaricus barssii,2,1,3,0.056801432979852025,0.0803492820202322
Leucoagaricus leucothites,1,1,2,0.2685730424867646,0.6723203844978234
Leucocrinum montanum,0,3,3,1.0,1.0
Leucoma salicis,0,16,16,0.15161267346782015,0.19687992504129675
Leuconotopicus albolarvatus,41,820,861,5.1693932290210475e-20,7.007336984570787e-16
Leuconotopicus villosus,42,307,349,0.22269907463457506,0.22186265721659465
Leucopaxillus albissimus,2,6,8,0.3262180684327187,0.7311980927864552
Leucopaxillus gentianeus,15,11,26,4.0040020296190745e-07,2.1728785050292672e-09
Leucophysalis nana,0,34,34,0.011544912843706439,0.03112496262794068
Leucorrhinia glacialis,0,13,13,0.23752623411074927,0.27601031745794824
Leucorrhinia hudsonica,0,6,6,0.6025804396089913,0.6688993551184468
Leucorrhinia intacta,0,19,19,0.09746384240092232,0.14226189947649115
Leucosticte tephrocotis,0,35,35,0.0069115977543475066,0.028234654159491945
Leucothoe davisiae,0,51,51,0.0005177884379523655,0.006152910162560303
Leuronychus pacificus,3,5,8,0.09660076546782431,0.17754400284199642
Lewisia cantelovii,1,14,15,0.7118339050632088,0.6221922979706558
Lewisia congdonii,0,3,3,1.0,1.0
Lewisia disepala,1,5,6,1.0,1.0
Lewisia kelloggii,0,26,26,0.025555133894118995,0.0688671495635685
Lewisia leeana,0,17,17,0.15747128520432685,0.17645428752866515
Lewisia longipetala,0,2,2,1.0,1.0
Lewisia nevadensis,0,65,65,6.060196236241893e-05,0.001682231195901802
Lewisia pygmaea,0,6,6,0.6025804396089913,0.6688993551184468
Lewisia rediviva,12,35,47,0.03818474512541645,0.051536501849176304
Lewisia triphylla,1,79,80,9.048658353492115e-05,0.001355767691014155
Leymus cinereus,0,10,10,0.3757244358299004,0.39438447212016514
Leymus triticoides,1,0,1,0.14476460320460613,0.3126936942061339
Libellula forensis,0,25,25,0.04095412181173697,0.07622457957144455
Libellula luctuosa,21,8,29,3.0773416971676517e-12,7.70554220632325e-18
Libellula nodisticta,0,5,5,1.0,0.7760428250025136
Libellula pulchella,20,82,102,0.15744214830255993,0.18269596301197308
Libellula quadrimaculata,2,164,166,3.3934114919153772e-09,2.020626545630514e-06
Libellula saturata,17,41,58,0.0040137940124242155,0.002490275124881287
Libytheana carinenta,0,1,1,1.0,1.0
Lichanura orcutti,0,1,1,1.0,1.0
Ligidium latum,0,4,4,1.0,0.9105509465652237
Ligusticum grayi,0,114,114,2.8087158539089662e-08,2.0357521807211066e-05
Lilium columbianum,0,1,1,1.0,1.0
Lilium humboldtii,99,61,160,5.7189352603274476e-43,2.5354830694745326e-64
Lilium kelleyanum,28,530,558,9.62762878979282e-13,3.002581464279208e-10
Lilium pardalinum,41,242,283,1.0,1.0
Lilium parvum,10,1280,1290,1.8612220589368924e-71,1.749621865634511e-44
Lilium washingtonianum,15,291,306,1.3278759922160662e-07,2.8360925035669974e-06
Limacus flavus,2,4,6,0.21128172197002185,0.4637992200137968
Limax maximus,3,0,3,0.0030335293929702875,0.000700171082788584
Limenitis bredowii,183,423,606,4.3298907231649714e-23,6.068972019482782e-28
Limenitis lorquini,47,295,342,0.7584959840901742,0.7572580377949443
Limenitis weidemeyerii,0,2,2,1.0,1.0
Limnanthes alba,9,12,21,0.001561053758546138,0.0007083765605496772
Limnellia turneri,0,1,1,1.0,1.0
Limnodromus scolopaceus,1,0,1,0.14476460320460613,0.3126936942061339
Limnoporus notabilis,0,1,1,1.0,1.0
Limosa fedoa,0,1,1,1.0,1.0
Linanthus dichotomus,5,2,7,0.0010327341762908842,0.00018014051424031924
Linanthus harknessii,0,5,5,1.0,0.7760428250025136
Linanthus inyoensis,3,10,13,0.41916983303031286,0.626122924488651
Linanthus parryae,6,5,11,0.002201136146005925,0.0008124952796229928
Linanthus pungens,8,138,146,0.0008935886893861664,0.002948250461587154
Linaria dalmatica,0,1,1,1.0,1.0
Linaria vulgaris,0,10,10,0.3757244358299004,0.39438447212016514
Lindbladia tubulina,0,1,1,1.0,1.0
Lindernia dubia,1,0,1,0.14476460320460613,0.3126936942061339
Linepithema humile,2,0,2,0.0209561639230412,0.01499159650771353
Linnaea borealis,7,22,29,0.17905355349020763,0.22441395054074903
Linognathus setosus,0,1,1,1.0,1.0
Linum bienne,4,0,4,0.00043910829886184923,3.314336839661014e-05
Linum grandiflorum,1,0,1,0.14476460320460613,0.3126936942061339
Linum lewisii,3,154,157,1.517398369773092e-07,1.2829935267695444e-05
Liometopum luctuosum,6,8,14,0.00969297744733247,0.00833304449065533
Liometopum occidentale,19,21,40,6.704032769815336e-07,1.1185199947887077e-08
Liorhyssus hyalinus,0,3,3,1.0,1.0
Lipoptena depressa,1,0,1,0.14476460320460613,0.3126936942061339
Liriomyza galiivora,0,1,1,1.0,1.0
Litaneutria ocularis,1,0,1,0.14476460320460613,0.3126936942061339
Lithobates catesbeianus,26,69,95,0.0010828128507112242,0.0006121563995990988
Litholomia napaea,0,2,2,1.0,1.0
Lithophane dilatocula,0,1,1,1.0,1.0
Lithophragma affine,1,1,2,0.2685730424867646,0.6723203844978234
Lithophragma bolanderi,5,3,8,0.0024244129099057063,0.0007850786162003298
Lithophragma campanulatum,0,3,3,1.0,1.0
Lithophragma glabrum,0,48,48,0.0007986906096022093,0.008153714424496968
Lithophragma heterophyllum,1,8,9,1.0,1.0
Lithophragma parviflorum,3,9,12,0.3994183286503844,0.5314104390489738
Lithospermum californicum,13,8,21,7.876614523055535e-07,4.433227163928297e-09
Lithospermum ruderale,1,6,7,1.0,1.0
Litocala sexsignata,1,27,28,0.1715694357066057,0.17021690282597887
Lixus perforatus,0,2,2,1.0,1.0
Lobaria anomala,2,1,3,0.056801432979852025,0.0803492820202322
Lobaria anthraspis,3,1,4,0.010816792675262966,0.00633924523846032
Lobularia maritima,1,2,3,0.3744588472376553,0.9141432822130974
Loeseliastrum matthewsii,1,0,1,0.14476460320460613,0.3126936942061339
Logfia californica,1,0,1,0.14476460320460613,0.3126936942061339
Logfia gallica,0,1,1,1.0,1.0
Lolium arundinaceum,1,0,1,0.14476460320460613,0.3126936942061339
Lolium perenne,1,0,1,0.14476460320460613,0.3126936942061339
Lomatium californicum,2,0,2,0.0209561639230412,0.01499159650771353
Lomatium dasycarpum,0,1,1,1.0,1.0
Lomatium foeniculaceum,2,26,28,0.41855855454898133,0.4040672905640138
Lomatium fusiformis,0,2,2,1.0,1.0
Lomatium macrocarpum,0,4,4,1.0,0.9105509465652237
Lomatium marginatum,1,1,2,0.2685730424867646,0.6723203844978234
Lomatium mohavense,3,0,3,0.0030335293929702875,0.000700171082788584
Lomatium multifidum,0,12,12,0.2360424886052977,0.31009055076592434
Lomatium nevadense,1,8,9,1.0,1.0
Lomatium nudicaule,0,8,8,0.6124215574698968,0.5084255632839996
Lomatium rigidum,0,3,3,1.0,1.0
Lomatium shevockii,0,1,1,1.0,1.0
Lomatium stebbinsii,0,6,6,0.6025804396089913,0.6688993551184468
Lomatium torreyi,0,1,1,1.0,1.0
Lomatium utriculatum,5,4,9,0.004804892843884087,0.0024551155675152643
Lon melane,8,1,9,1.5113716238966603e-06,4.3344519411722725e-09
Lonicera caerulea,0,28,28,0.02673836112705098,0.056309179680095994
Lonicera conjugialis,0,318,318,4.4401526740999255e-22,3.7893795367342744e-13
Lonicera hispidula,118,46,164,7.774988697347763e-62,3.1057881033051466e-96
Lonicera interrupta,10,6,16,1.3907974774475057e-05,3.3203009379277213e-07
Lonicera involucrata,4,291,295,3.8040306739111095e-15,2.5072867439722326e-10
Lonicera japonica,1,0,1,0.14476460320460613,0.3126936942061339
Lontra canadensis,9,19,28,0.014199500458381647,0.016922455686641368
Lophocampa argentata,33,195,228,1.0,1.0
Lophocampa maculata,2,120,122,1.9916776954468865e-06,9.52992419657912e-05
Lophodermium abietis,0,1,1,1.0,1.0
Lophodermium nitens,0,1,1,1.0,1.0
Lophodermium pinastri,0,1,1,1.0,1.0
Lophodytes cucullatus,2,6,8,0.3262180684327187,0.7311980927864552
Lotus corniculatus,5,47,52,0.42992174264014454,0.4241292349065767
Loxia curvirostra,1,76,77,0.00013527877473571852,0.0017779709845523765
Lucilia sericata,2,0,2,0.0209561639230412,0.01499159650771353
Ludwigia hexapetala,1,0,1,0.14476460320460613,0.3126936942061339
Ludwigia peploides,1,0,1,0.14476460320460613,0.3126936942061339
Lumbricus terrestris,1,0,1,0.14476460320460613,0.3126936942061339
Lunaria annua,17,42,59,0.0044546317849525775,0.0032272881939146916
Lunularia cruciata,9,0,9,2.7892926019110602e-08,9.215270667313031e-12
Lupinus albicaulis,4,0,4,0.00043910829886184923,3.314336839661014e-05
Lupinus albifrons,6,2,8,0.00019772693610894856,1.2839299064071593e-05
Lupinus andersonii,0,3,3,1.0,1.0
Lupinus angustiflorus,0,37,37,0.004488086548002733,0.02325691778527045
Lupinus apertus,0,9,9,0.37460992252836506,0.4468858706621094
Lupinus arbustus,0,13,13,0.23752623411074927,0.27601031745794824
Lupinus argenteus,3,24,27,0.7886865336637121,0.8231296973634802
Lupinus benthamii,1,2,3,0.3744588472376553,0.9141432822130974
Lupinus bicolor,6,2,8,0.00019772693610894856,1.2839299064071593e-05
Lupinus brevicaulis,2,16,18,1.0,0.9435167712853587
Lupinus breweri,7,65,72,0.31497173115601557,0.32747682823752533
Lupinus burkei,0,37,37,0.004488086548002733,0.02325691778527045
Lupinus caespitosus,0,5,5,1.0,0.7760428250025136
Lupinus caudatus,0,2,2,1.0,1.0
Lupinus citrinus,13,5,18,5.1012562678773784e-08,3.3993804082578516e-11
Lupinus concinnus,1,1,2,0.2685730424867646,0.6723203844978234
Lupinus confertus,1,1,2,0.2685730424867646,0.6723203844978234
Lupinus congdonii,0,3,3,1.0,1.0
Lupinus covillei,0,24,24,0.03967208129449859,0.08442030606095953
Lupinus dalesiae,0,5,5,1.0,0.7760428250025136
Lupinus densiflorus,1,1,2,0.2685730424867646,0.6723203844978234
Lupinus duranii,0,12,12,0.2360424886052977,0.31009055076592434
Lupinus elatus,0,1,1,1.0,1.0
Lupinus flavoculatus,2,1,3,0.056801432979852025,0.0803492820202322
Lupinus formosus,3,2,5,0.02413002787627292,0.023975245305455268
Lupinus fulcratus,0,11,11,0.38449278358904854,0.3492157200022511
Lupinus grayi,6,71,77,0.10537942027668976,0.1322442015266114
Lupinus latifolius,5,32,37,1.0,1.0
Lupinus lepidus,1,35,36,0.05366113706417981,0.07871453340573546
Lupinus magnificus,0,1,1,1.0,1.0
Lupinus meionanthus,0,7,7,0.6034645370398923,0.5813304975648097
Lupinus microcarpus,4,1,5,0.0019413025415773043,0.00041787713651955216
Lupinus nanus,15,1,16,3.5430646499797675e-12,4.845369092180349e-18
Lupinus obtusilobus,0,2,2,1.0,1.0
Lupinus onustus,0,1,1,1.0,1.0
Lupinus padre-crowleyi,1,8,9,1.0,1.0
Lupinus polyphyllus,9,87,96,0.19063352743208722,0.2020164444684088
Lupinus pratensis,0,8,8,0.6124215574698968,0.5084255632839996
Lupinus pusillus,0,1,1,1.0,1.0
Lupinus sellulus,0,9,9,0.37460992252836506,0.4468858706621094
Lupinus sericeus,0,1,1,1.0,1.0
Lupinus spectabilis,1,0,1,0.14476460320460613,0.3126936942061339
Lupinus stiversii,80,191,271,2.0148327467409613e-10,3.4815333896883034e-12
Lupinus succulentus,0,1,1,1.0,1.0
Lupinus uncialis,0,3,3,1.0,1.0
Lupinus vallicola,0,2,2,1.0,1.0
Luzula comosa,2,3,5,0.15522343689242213,0.32387652224382535
Luzula divaricata,0,4,4,1.0,0.9105509465652237
Luzula macrantha,3,1,4,0.010816792675262966,0.00633924523846032
Luzula orestera,0,3,3,1.0,1.0
Luzula parviflora,0,1,1,1.0,1.0
Luzula spicata,0,2,2,1.0,1.0
Lycaeides anna,0,120,120,1.2119024522345047e-08,1.194874959103131e-05
Lycaeides melissa,2,6,8,0.3262180684327187,0.7311980927864552
Lycaena cupreus,1,108,109,1.624647792166332e-06,0.00010101980156106857
Lycogala epidendrum,6,12,18,0.035903562045316396,0.05251993186095004
Lycoperdon molle,1,0,1,0.14476460320460613,0.3126936942061339
Lycoperdon perlatum,9,8,17,0.00022350676454465927,3.1437133229831e-05
Lycoperdon subcretaceum,1,15,16,0.4958553183213633,0.5619415773454699
Lycoperdon umbrinum,0,4,4,1.0,0.9105509465652237
Lycopodiella inundata,1,0,1,0.14476460320460613,0.3126936942061339
Lygaeus kalmii,11,13,24,0.0002324108505869028,4.5818813537029864e-05
Lygephila victoria,0,2,2,1.0,1.0
Lynx rufus,34,93,127,0.00032652286757725254,0.00013728020546439866
Lyophyllum anthracophilum,0,1,1,1.0,1.0
Lyophyllum decastes,2,1,3,0.056801432979852025,0.0803492820202322
Lysimachia arvensis,2,4,6,0.21128172197002185,0.4637992200137968
Lysimachia latifolia,141,241,382,1.7201424789896496e-27,2.583696773101679e-35
Lysimachia nummularia,0,2,2,1.0,1.0
Lythrum portula,0,2,2,1.0,1.0
Lythrum salicaria,1,1,2,0.2685730424867646,0.6723203844978234
Lytta magister,1,0,1,0.14476460320460613,0.3126936942061339
Lytta nuttallii,0,2,2,1.0,1.0
Lytta stygica,0,6,6,0.6025804396089913,0.6688993551184468
Lytta vulnerata,1,0,1,0.14476460320460613,0.3126936942061339
Macaria adonis,3,16,19,0.7489337316443154,1.0
Macaria bitactata,0,4,4,1.0,0.9105509465652237
Macaria colata,1,24,25,0.2476906644158463,0.22836298286850215
Macaria guenearia,0,1,1,1.0,1.0
Macaria lorquinaria,0,3,3,1.0,1.0
Macaria quadrilinearia,0,1,1,1.0,1.0
Macaria signaria,0,2,2,1.0,1.0
Machimus occidentalis,0,1,1,1.0,1.0
Maclura pomifera,1,0,1,0.14476460320460613,0.3126936942061339
Macroglossum stellatarum,0,1,1,1.0,1.0
Macromia magnifica,1,1,2,0.2685730424867646,0.6723203844978234
Macrosiphum albifrons,0,6,6,0.6025804396089913,0.6688993551184468
Macrosiphum gaurae,1,0,1,0.14476460320460613,0.3126936942061339
Madia citriodora,0,1,1,1.0,1.0
Madia elegans,83,81,164,1.0903693935487417e-27,6.754478278713867e-39
Madia exigua,2,11,13,1.0,1.0
Madia glomerata,0,28,28,0.02673836112705098,0.056309179680095994
Madia gracilis,13,37,50,0.026887216084230173,0.0344227305585706
Madia subspicata,1,0,1,0.14476460320460613,0.3126936942061339
Mahonia aquifolium,32,41,73,1.4435998560610022e-09,3.3072416889071692e-12
Mahonia dictyota,13,9,22,1.6684200887526498e-06,1.6560542037460232e-08
Mahonia nervosa,4,2,6,0.005153189017352294,0.0022646484484871816
Mahonia repens,1,2,3,0.3744588472376553,0.9141432822130974
Maianthemum racemosum,78,759,837,8.855382113899779e-06,2.664876823563052e-05
Maianthemum stellatum,14,227,241,3.204080086758323e-05,0.00018789390865519477
Malacosoma californica,6,96,102,0.010662000823456246,0.019983394334894752
Malacosoma constricta,15,9,24,9.052156903838177e-08,1.5884856688392777e-10
Malacothamnus fremontii,1,12,13,0.7073310728950297,0.7633631983104203
Malacothrix floccifera,0,13,13,0.23752623411074927,0.27601031745794824
Malacothrix glabrata,1,2,3,0.3744588472376553,0.9141432822130974
Malacothrix sonchoides,0,1,1,1.0,1.0
Mallocybe fibrillosa,0,1,1,1.0,1.0
Malus domestica,1,2,3,0.3744588472376553,0.9141432822130974
Malva neglecta,1,6,7,1.0,1.0
Malva nicaeensis,1,0,1,0.14476460320460613,0.3126936942061339
Malva parviflora,0,1,1,1.0,1.0
Manduca quinquemaculatus,0,5,5,1.0,0.7760428250025136
Manduca sexta,6,2,8,0.00019772693610894856,1.2839299064071593e-05
Manica bradleyi,3,30,33,0.6179221844100273,0.52742686745067
Manica invidia,0,2,2,1.0,1.0
Mannia californica,0,2,2,1.0,1.0
Mantis religiosa,8,13,21,0.006699026881832412,0.00567301776099004
Marah horrida,1,3,4,0.4650164385481151,1.0
Marah watsonii,13,11,24,6.2893924412739875e-06,1.638204404313359e-07
Marasmius calhouniae,7,0,7,1.3315701680073362e-06,3.775277184632102e-09
Marasmius oreades,0,1,1,1.0,1.0
Marasmius plicatulus,2,1,3,0.056801432979852025,0.0803492820202322
Marchantia polymorpha,10,112,122,0.05250285016531446,0.06530078884935564
Marchena minuta,2,1,3,0.056801432979852025,0.0803492820202322
Mareca americana,1,3,4,0.4650164385481151,1.0
Mareca strepera,0,6,6,0.6025804396089913,0.6688993551184468
Margaritifera falcata,1,8,9,1.0,1.0
Marmara arbutiella,10,4,14,2.3010529812760674e-06,1.3738561767643127e-08
Marmota flaviventris,10,524,534,1.1578650426304969e-23,1.9178637319933702e-16
Marrubium vulgare,8,4,12,5.508489772806841e-05,2.266634219630844e-06
Marsilea oligospora,0,1,1,1.0,1.0
Martes caurina,1,22,23,0.23832747917939356,0.27824213268427256
Martininia panamaensis,1,0,1,0.14476460320460613,0.3126936942061339
Massospora levispora,0,1,1,1.0,1.0
Masticophis flagellum,2,1,3,0.056801432979852025,0.0803492820202322
Masticophis lateralis,11,13,24,0.0002324108505869028,4.5818813537029864e-05
Masticophis taeniatus,1,5,6,1.0,1.0
Mastor vialis,3,1,4,0.010816792675262966,0.00633924523846032
Matheteus theveneti,0,4,4,1.0,0.9105509465652237
Matricaria discoidea,8,15,23,0.01235984894699688,0.013453492698040059
Matsucoccus acalyptus,0,1,1,1.0,1.0
Mecas bicallosa,0,1,1,1.0,1.0
Mecyna mustelinalis,0,7,7,0.6034645370398923,0.5813304975648097
Medicago lupulina,0,20,20,0.10203106758234803,0.12794167189413608
Medicago polymorpha,4,0,4,0.00043910829886184923,3.314336839661014e-05
Medicago sativa,2,8,10,0.6456440117183423,0.9624710515030661
Meesia triquetra,0,17,17,0.15747128520432685,0.17645428752866515
Megaceryle alcyon,1,11,12,1.0,0.845714857147599
Megachile angelarum,1,1,2,0.2685730424867646,0.6723203844978234
Megachile apicalis,0,1,1,1.0,1.0
Megachile fidelis,0,2,2,1.0,1.0
Megachile melanophaea,0,2,2,1.0,1.0
Megachile montivaga,0,1,1,1.0,1.0
Megachile perihirta,0,4,4,1.0,0.9105509465652237
Megachile pugnata,0,2,2,1.0,1.0
Megacollybia fallax,0,2,2,1.0,1.0
Megahexura fulva,0,2,2,1.0,1.0
Megapenthes tartareus,0,1,1,1.0,1.0
Megarhyssa nortoni,2,88,90,0.0002257141821059388,0.001605631593388589
Megascops kennicottii,13,14,27,3.2941979093487867e-05,2.610230905713789e-06
Megasyrphus laxus,0,4,4,1.0,0.9105509465652237
Megeleates sequoiarum,0,2,2,1.0,1.0
Melampsorella elatina,0,12,12,0.2360424886052977,0.31009055076592434
Melanchra pulverulenta,0,1,1,1.0,1.0
Melanerpes formicivorus,105,68,173,2.4196498246654965e-44,4.0270348679154855e-66
Melanerpes lewis,37,35,72,1.8546541965300852e-13,2.4224218794004716e-18
Melanogaster tuberiformis,0,1,1,1.0,1.0
Melanolestes picipes,1,0,1,0.14476460320460613,0.3126936942061339
Melanoleuca angelesiana,0,5,5,1.0,0.7760428250025136
Melanoleuca cognata,0,4,4,1.0,0.9105509465652237
Melanoleuca dryophila,0,1,1,1.0,1.0
Melanoleuca exscissa,1,0,1,0.14476460320460613,0.3126936942061339
Melanoleuca melaleuca,0,3,3,1.0,1.0
Melanoleuca strictipes,0,2,2,1.0,1.0
Melanoleuca verrucipes,1,0,1,0.14476460320460613,0.3126936942061339
Melanoleuca yatesii,1,0,1,0.14476460320460613,0.3126936942061339
Melanolophia imitata,1,23,24,0.24143280901572373,0.25202843593319213
Melanophila consputa,0,3,3,1.0,1.0
Melanoplus devastator,0,1,1,1.0,1.0
Melanoplus sanguinipes,0,8,8,0.6124215574698968,0.5084255632839996
Meleagris gallopavo,93,45,138,3.7503257726866183e-45,5.807254733304551e-69
Melica aristata,0,1,1,1.0,1.0
Melica californica,0,1,1,1.0,1.0
Melica fugax,0,1,1,1.0,1.0
Melica geyeri,0,1,1,1.0,1.0
Melica harfordii,2,0,2,0.0209561639230412,0.01499159650771353
Melica stricta,6,21,27,0.268604493738199,0.3840576019500902
Melica subulata,0,1,1,1.0,1.0
Melica torreyana,2,0,2,0.0209561639230412,0.01499159650771353
Melilotus albus,13,35,48,0.021559801069856933,0.02275815644736088
Melilotus indicus,1,2,3,0.3744588472376553,0.9141432822130974
Melilotus officinalis,1,14,15,0.7118339050632088,0.6221922979706558
Melipotis jucunda,1,3,4,0.4650164385481151,1.0
Melissa officinalis,12,2,14,5.776306606320184e-09,6.210056186652793e-13
Meloe strigulosus,0,1,1,1.0,1.0
Meloe vandykei,1,0,1,0.14476460320460613,0.3126936942061339
Melopsittacus undulatus,1,0,1,0.14476460320460613,0.3126936942061339
Melospiza lincolnii,1,55,56,0.003475445864171745,0.012090493760844609
Melospiza melodia,8,121,129,0.005484327483442504,0.010872149208109647
Melozone crissalis,42,14,56,3.761197960097323e-24,7.266710107555495e-37
Menemerus semilimbatus,1,0,1,0.14476460320460613,0.3126936942061339
Menkeleon bellulus,0,1,1,1.0,1.0
Menodora spinescens,1,0,1,0.14476460320460613,0.3126936942061339
Mentha canadensis,1,9,10,1.0,1.0
Mentha pulegium,4,6,10,0.044556650138771095,0.06510377152388026
Mentha spicata,0,2,2,1.0,1.0
Mentha suaveolens,1,0,1,0.14476460320460613,0.3126936942061339
Mentzelia albicaulis,0,7,7,0.6034645370398923,0.5813304975648097
Mentzelia congesta,2,3,5,0.15522343689242213,0.32387652224382535
Mentzelia crocea,1,7,8,1.0,1.0
Mentzelia dispersa,0,2,2,1.0,1.0
Mentzelia inyoensis,0,1,1,1.0,1.0
Mentzelia laevicaulis,5,29,34,1.0,1.0
Mentzelia montana,0,2,2,1.0,1.0
Mentzelia nitens,0,1,1,1.0,1.0
Mentzelia oreophila,2,0,2,0.0209561639230412,0.01499159650771353
Mentzelia torreyi,0,12,12,0.2360424886052977,0.31009055076592434
Mentzelia veatchiana,0,1,1,1.0,1.0
Menyanthes trifoliata,0,43,43,0.00188367039695229,0.013084970189199272
Mephitis mephitis,14,13,27,5.434053754178943e-06,1.5517767991261642e-07
Mergus merganser,7,163,170,2.5021271895386685e-05,0.00019063872498041248
Mergus serrator,1,0,1,0.14476460320460613,0.3126936942061339
Merhynchites bicolor,1,1,2,0.2685730424867646,0.6723203844978234
Merodon equestris,1,0,1,0.14476460320460613,0.3126936942061339
Mertensia ciliata,2,115,117,4.42124899745279e-06,0.00014795263791939737
Mertensia nevadensis,0,2,2,1.0,1.0
Mesoleuca gratulata,0,1,1,1.0,1.0
Metaltella simoni,0,1,1,1.0,1.0
Metaphidippus manni,0,1,1,1.0,1.0
Metleucauge eldorado,0,1,1,1.0,1.0
Metrius contractus,1,9,10,1.0,1.0
Mezira pacifica,0,1,1,1.0,1.0
Micranthes aprica,0,30,30,0.016694385851981373,0.04613372038512279
Micranthes bryophora,0,32,32,0.010653294055563268,0.03786379733207584
Micranthes californica,23,4,27,4.754305691683416e-16,2.7226342748354135e-24
Micranthes integrifolia,3,0,3,0.0030335293929702875,0.000700171082788584
Micranthes mertensiana,0,1,1,1.0,1.0
Micranthes nidifica,0,6,6,0.6025804396089913,0.6688993551184468
Micranthes odontoloma,1,35,36,0.05366113706417981,0.07871453340573546
Micranthes oregana,0,106,106,1.007902773910342e-07,4.150537888657731e-05
Micranthes tolmiei,0,9,9,0.37460992252836506,0.4468858706621094
Microcentrum californicum,2,6,8,0.3262180684327187,0.7311980927864552
Microcentrum rhombifolium,0,1,1,1.0,1.0
Microglossum viride,0,1,1,1.0,1.0
Microphotus angustus,7,1,8,9.303494096827296e-06,7.976934310518629e-08
Micropterus dolomieu,4,3,7,0.0106471288054473,0.007559096939159896
Micropuntia pulchella,0,2,2,1.0,1.0
Microseris alpestris,0,1,1,1.0,1.0
Microseris lindleyi,9,5,14,2.785639213432983e-05,8.786751400281266e-07
Microseris nutans,0,15,15,0.14994170356869613,0.21998124924271661
Microtheoris ophionalis,0,1,1,1.0,1.0
Microtus longicaudus,0,3,3,1.0,1.0
Microtus montanus,0,4,4,1.0,0.9105509465652237
Mimetanthe pilosa,5,11,16,0.06970472631189019,0.12074944300889731
Mimorista subcostalis,2,0,2,0.0209561639230412,0.01499159650771353
Mimoschinia rufofascialis,0,14,14,0.24486350799097997,0.24618548812479032
Mimus polyglottos,1,0,1,0.14476460320460613,0.3126936942061339
Minettia flaveola,0,2,2,1.0,1.0
Mioptachys flavicauda,0,1,1,1.0,1.0
Mirabilis jalapa,1,0,1,0.14476460320460613,0.3126936942061339
Mirabilis multiflora,0,4,4,1.0,0.9105509465652237
Mischocyttarus flavitarsis,11,14,25,0.00036082424937183794,9.17780469169073e-05
Misumena vatia,3,73,76,0.00513469674221299,0.014438408534889039
Misumenoides formosipes,1,1,2,0.2685730424867646,0.6723203844978234
Mitoura gryneus,6,62,68,0.22774908530920307,0.24903865338507675
Mitoura nelsoni,8,114,122,0.009704125253358092,0.018375689773329578
Mitoura siva,0,2,2,1.0,1.0
Mitoura spinetorum,1,9,10,1.0,1.0
Mitrula elegans,0,8,8,0.6124215574698968,0.5084255632839996
Modicella malleola,0,2,2,1.0,1.0
Moehringia macrophylla,2,4,6,0.21128172197002185,0.4637992200137968
Mohavacris timberlakei,8,0,8,1.9272389244988723e-07,1.8600410733089334e-10
Molorchus bimaculatus,0,2,2,1.0,1.0
Molorchus longicollis,0,2,2,1.0,1.0
Molothrus ater,8,82,90,0.17528147573910874,0.17477298311086872
Mompha albocapitella,0,1,1,1.0,1.0
Mompha circumscriptella,0,4,4,1.0,0.9105509465652237
Monadenia mormonum,2,15,17,1.0,1.0
Monadenia yosemitensis,0,2,2,1.0,1.0
Monardella breweri,2,8,10,0.6456440117183423,0.9624710515030661
Monardella linoides,1,3,4,0.4650164385481151,1.0
Monardella odoratissima,13,559,572,2.3159971024625663e-23,1.616970805563059e-16
Monardella sheltonii,1,1,2,0.2685730424867646,0.6723203844978234
Moneilema semipunctatum,2,0,2,0.0209561639230412,0.01499159650771353
Monochamus clamator,6,44,50,0.8400917083168675,0.7666589621564849
Monochamus obtusus,12,75,87,1.0,0.9770190558538931
Monochamus scutellatus,18,303,321,6.705156596686846e-07,8.984277936787269e-06
Monocrepidius bellus,1,0,1,0.14476460320460613,0.3126936942061339
Montagnea arenaria,4,1,5,0.0019413025415773043,0.00041787713651955216
Montia chamissoi,0,51,51,0.0005177884379523655,0.006152910162560303
Montia fontana,0,2,2,1.0,1.0
Montia linearis,0,14,14,0.24486350799097997,0.24618548812479032
Montia parvifolia,2,16,18,1.0,0.9435167712853587
Morchella americana,1,2,3,0.3744588472376553,0.9141432822130974
Morchella brunnea,3,20,23,1.0,1.0
Morchella exuberans,0,1,1,1.0,1.0
Morchella importuna,0,3,3,1.0,1.0
Morchella populiphila,0,1,1,1.0,1.0
Morchella sextelata,1,1,2,0.2685730424867646,0.6723203844978234
Morchella snyderi,10,85,95,0.3101105773301582,0.34280065439826957
Morchella tomentosa,0,11,11,0.38449278358904854,0.3492157200022511
Morchella tridentina,4,12,16,0.2740043737810785,0.40028983280731434
Mordella hubbsi,1,0,1,0.14476460320460613,0.3126936942061339
Morsea piute,0,2,2,1.0,1.0
Morulodes setosus,1,0,1,0.14476460320460613,0.3126936942061339
Motyxia monica,1,0,1,0.14476460320460613,0.3126936942061339
Motyxia pior,0,1,1,1.0,1.0
Motyxia tiemanni,1,0,1,0.14476460320460613,0.3126936942061339
Motyxia tularea,0,1,1,1.0,1.0
Mucronella fusiformis,3,0,3,0.0030335293929702875,0.000700171082788584
Muhlenbergia asperifolia,0,1,1,1.0,1.0
Muhlenbergia filiformis,0,2,2,1.0,1.0
Muhlenbergia rigens,1,2,3,0.3744588472376553,0.9141432822130974
Muilla coronata,2,5,7,0.2688137426846044,0.6011437582684053
Muilla maritima,0,1,1,1.0,1.0
Muilla transmontana,0,4,4,1.0,0.9105509465652237
Mulsantina picta,0,21,21,0.06152025756350138,0.11517086832716916
Murgantia histrionica,2,1,3,0.056801432979852025,0.0803492820202322
Mus musculus,0,1,1,1.0,1.0
Musca autumnalis,0,1,1,1.0,1.0
Mustela erminea,0,1,1,1.0,1.0
Myadestes townsendi,5,193,198,2.3909784192700956e-08,2.8586150138391024e-06
Mycena acicula,4,4,8,0.01886984470142184,0.01861366248431812
Mycena amicta,0,1,1,1.0,1.0
Mycena bulliformis,2,3,5,0.15522343689242213,0.32387652224382535
Mycena capillaripes,11,1,12,6.080567969696642e-09,6.507654316294432e-13
Mycena clavicularis,2,0,2,0.0209561639230412,0.01499159650771353
Mycena corticola,2,0,2,0.0209561639230412,0.01499159650771353
Mycena epipterygia,1,6,7,1.0,1.0
Mycena galericulata,0,1,1,1.0,1.0
Mycena haematopus,4,5,9,0.030121806187693938,0.03739180706614353
Mycena leptocephala,3,2,5,0.02413002787627292,0.023975245305455268
Mycena maculata,3,0,3,0.0030335293929702875,0.000700171082788584
Mycena meliigena,1,0,1,0.14476460320460613,0.3126936942061339
Mycena nivicola,0,40,40,0.002903232974393092,0.017424485372976518
Mycena oregonensis,11,7,18,6.8896460561375466e-06,1.2342894153835435e-07
Mycena overholtsii,0,28,28,0.02673836112705098,0.056309179680095994
Mycena pura,8,13,21,0.006699026881832412,0.00567301776099004
Mycena purpureofusca,10,11,21,0.000305085182763721,6.16180009236958e-05
Mycena silvae-nigrae,0,7,7,0.6034645370398923,0.5813304975648097
Mycetina hornii,0,5,5,1.0,0.7760428250025136
Mycetinis copelandii,11,0,11,5.842142551198456e-10,2.291451781641987e-14
Mycocalicium subtile,0,1,1,1.0,1.0
Mycogone rosea,0,1,1,1.0,1.0
Mycterophora longipalpata,0,1,1,1.0,1.0
Mycterophora rubricans,0,8,8,0.6124215574698968,0.5084255632839996
Myiarchus cinerascens,8,11,19,0.00325413487701567,0.0019561111666591894
Mylopharodon conocephalus,0,1,1,1.0,1.0
Myosotis discolor,2,3,5,0.15522343689242213,0.32387652224382535
Myosotis latifolia,3,0,3,0.0030335293929702875,0.000700171082788584
Myosotis laxa,2,2,4,0.10278607328810296,0.1906437976216683
Myosotis scorpioides,0,3,3,1.0,1.0
Myosotis stricta,2,2,4,0.10278607328810296,0.1906437976216683
Myotis evotis,0,9,9,0.37460992252836506,0.4468858706621094
Myotis lucifugus,0,1,1,1.0,1.0
Myotis thysanodes,0,1,1,1.0,1.0
Myotis yumanensis,0,1,1,1.0,1.0
Myrica hartwegii,0,4,4,1.0,0.9105509465652237
Myriophyllum aquaticum,1,0,1,0.14476460320460613,0.3126936942061339
Myriophyllum spicatum,0,1,1,1.0,1.0
Myriopteris covillei,5,3,8,0.0024244129099057063,0.0007850786162003298
Myriopteris gracillima,5,137,142,3.596309103291998e-05,0.0003278614541640256
Myriopteris intertexta,0,6,6,0.6025804396089913,0.6688993551184468
Myrmecocystus testaceus,0,1,1,1.0,1.0
Myrmecophilus oregonensis,0,2,2,1.0,1.0
Myrmeleon exitialis,0,1,1,1.0,1.0
Myrmex lineatus,2,0,2,0.0209561639230412,0.01499159650771353
Myxarium nucleatum,1,0,1,0.14476460320460613,0.3126936942061339
Myxomphalia maura,4,21,25,0.7763237708742521,1.0
Myzia interrupta,1,13,14,0.7079821656760785,0.6890993041903317
Myzia subvittata,0,1,1,1.0,1.0
Myzus cerasi,0,1,1,1.0,1.0
Nabis americoferus,0,1,1,1.0,1.0
Nadata gibbosa,4,4,8,0.01886984470142184,0.01861366248431812
Naematelia aurantia,36,13,49,2.1851926129063197e-20,8.836502862578457e-31
Nama aretioides,1,1,2,0.2685730424867646,0.6723203844978234
Nama californicum,1,0,1,0.14476460320460613,0.3126936942061339
Nama demissa,1,1,2,0.2685730424867646,0.6723203844978234
Nama densa,0,3,3,1.0,1.0
Nama hispida,1,0,1,0.14476460320460613,0.3126936942061339
Nama lobbii,0,25,25,0.04095412181173697,0.07622457957144455
Nama rothrockii,3,8,11,0.2054644031680506,0.4367258119699784
Nandina domestica,0,1,1,1.0,1.0
Narcissea cordispora,0,1,1,1.0,1.0
Narcissea ephemeroides,0,1,1,1.0,1.0
Narcissus pseudonarcissus,1,0,1,0.14476460320460613,0.3126936942061339
Narthecium californicum,0,11,11,0.38449278358904854,0.3492157200022511
Nasonovia aquilegiae,0,1,1,1.0,1.0
Nasturtium officinale,8,12,20,0.004741703787194284,0.003428996841163759
Nathalis iole,0,1,1,1.0,1.0
Naucoria escharioides,0,1,1,1.0,1.0
Navarretia aeroides,0,2,2,1.0,1.0
Navarretia breweri,1,15,16,0.4958553183213633,0.5619415773454699
Navarretia crystallina,0,6,6,0.6025804396089913,0.6688993551184468
Navarretia divaricata,1,31,32,0.07681223748290478,0.11551429347859357
Navarretia filicaulis,2,0,2,0.0209561639230412,0.01499159650771353
Navarretia heterandra,1,0,1,0.14476460320460613,0.3126936942061339
Navarretia intertexta,6,39,45,1.0,0.9951293779774052
Navarretia leptalea,0,241,241,6.142533505055056e-17,2.989809830340599e-10
Navarretia leucocephala,0,5,5,1.0,0.7760428250025136
Navarretia miwukensis,0,1,1,1.0,1.0
Navarretia prolifera,0,40,40,0.002903232974393092,0.017424485372976518
Navarretia pubescens,1,1,2,0.2685730424867646,0.6723203844978234
Navarretia squarrosa,2,0,2,0.0209561639230412,0.01499159650771353
Navarretia tagetina,1,0,1,0.14476460320460613,0.3126936942061339
Navarretia torreyella,1,15,16,0.4958553183213633,0.5619415773454699
Neacoryphus bicrucis,0,17,17,0.15747128520432685,0.17645428752866515
Nectria cinnabarina,2,0,2,0.0209561639230412,0.01499159650771353
Neduba inversa,0,1,1,1.0,1.0
Neduba radicata,0,5,5,1.0,0.7760428250025136
Neduba sierranus,0,4,4,1.0,0.9105509465652237
Nelima paessleri,0,3,3,1.0,1.0
Nemacladus bellus,1,2,3,0.3744588472376553,0.9141432822130974
Nemacladus calcaratus,1,2,3,0.3744588472376553,0.9141432822130974
Nemacladus capillaris,1,6,7,1.0,1.0
Nemacladus interior,6,2,8,0.00019772693610894856,1.2839299064071593e-05
Nemacladus inyoensis,1,18,19,0.5081076590495464,0.41485136099373987
Nemacladus rigidus,0,2,2,1.0,1.0
Nemacladus sigmoideus,7,8,15,0.002928859390410695,0.0014910704758996124
Nemognatha nigripennis,2,1,3,0.056801432979852025,0.0803492820202322
Nemognatha scutellaris,0,21,21,0.06152025756350138,0.11517086832716916
Nemophila heterophylla,61,49,110,1.6910237133467578e-23,1.309605568962384e-33
Nemophila maculata,28,239,267,0.06727224040737267,0.07723822905292045
Nemophila menziesii,53,31,84,2.5930323214017015e-24,6.452930874729283e-36
Nemophila parviflora,2,3,5,0.15522343689242213,0.32387652224382535
Nemophila pedunculata,2,5,7,0.2688137426846044,0.6011437582684053
Nemophila pulchella,1,2,3,0.3744588472376553,0.9141432822130974
Nemophila spatulata,0,10,10,0.3757244358299004,0.39438447212016514
Nemoria darwiniata,1,32,33,0.07843551151890064,0.10491406255241775
Nemoria glaucomarginaria,0,4,4,1.0,0.9105509465652237
Nemoria obliqua,0,4,4,1.0,0.9105509465652237
Nemoria pulcherrima,2,1,3,0.056801432979852025,0.0803492820202322
Nemoria unitaria,0,2,2,1.0,1.0
Neoalcis californiaria,1,0,1,0.14476460320460613,0.3126936942061339
Neoalosterna rubida,0,2,2,1.0,1.0
Neobellamira delicata,5,7,12,0.02071365806663339,0.023406060107138856
Neoclytus balteatus,0,1,1,1.0,1.0
Neoclytus conjunctus,1,2,3,0.3744588472376553,0.9141432822130974
Neoclytus magnus,1,1,2,0.2685730424867646,0.6723203844978234
Neoclytus resplendens,0,1,1,1.0,1.0
Neocoelidia fuscovittata,0,1,1,1.0,1.0
Neodiprion abietis,0,1,1,1.0,1.0
Neohermes californicus,12,14,26,0.00011121406719447666,1.6169485025480713e-05
Neolasioptera convolvuli,0,1,1,1.0,1.0
Neolasioptera lupini,0,1,1,1.0,1.0
Neolentinus ponderosus,22,374,396,2.6169200278563936e-08,6.396997786192475e-07
Neominois ridingsii,0,3,3,1.0,1.0
Neomyia cornicina,0,2,2,1.0,1.0
Neoneides muticus,0,2,2,1.0,1.0
Neopeckia coulteri,0,2,2,1.0,1.0
Neophasia menapia,0,92,92,8.468760068601877e-07,0.00014530276248556968
Neophyllura bicolor,0,1,1,1.0,1.0
Neospondylis upiformis,0,11,11,0.38449278358904854,0.3492157200022511
Neotephritis finalis,0,10,10,0.3757244358299004,0.39438447212016514
Neoterpes trianguliferata,1,22,23,0.23832747917939356,0.27824213268427256
Neotoma cinerea,0,5,5,1.0,0.7760428250025136
Neotoma lepida,0,2,2,1.0,1.0
Neotoma macrotis,0,2,2,1.0,1.0
Neotoxoptera formosana,1,0,1,0.14476460320460613,0.3126936942061339
Neottia convallarioides,0,54,54,0.0003367115756713232,0.004649855763319928
Nepeta cataria,0,1,1,1.0,1.0
Nephroma resupinatum,0,1,1,1.0,1.0
Nephromopsis merrillii,2,5,7,0.2688137426846044,0.6011437582684053
Nephromopsis orbata,1,1,2,0.2685730424867646,0.6723203844978234
Nephromopsis sphaerosporella,0,3,3,1.0,1.0
Nepytia lagunata,0,1,1,1.0,1.0
Neriene litigiosa,1,23,24,0.24143280901572373,0.25202843593319213
Neurotrichus gibbsii,2,0,2,0.0209561639230412,0.01499159650771353
Nicocles abdominalis,1,0,1,0.14476460320460613,0.3126936942061339
Nicotiana acuminata,1,1,2,0.2685730424867646,0.6723203844978234
Nicotiana attenuata,3,10,13,0.41916983303031286,0.626122924488651
Nicrophorus defodiens,0,4,4,1.0,0.9105509465652237
Nicrophorus guttula,0,1,1,1.0,1.0
Nicrophorus nigrita,1,4,5,0.5424646889787644,1.0
Nidula candida,0,1,1,1.0,1.0
Nidula niveotomentosa,4,8,12,0.08293252313214843,0.1480937371178578
Nidulariopsis iowensis,0,1,1,1.0,1.0
Nigella damascena,1,0,1,0.14476460320460613,0.3126936942061339
Nitella opaca,0,1,1,1.0,1.0
Nitrophila occidentalis,0,1,1,1.0,1.0
Noctua pronuba,5,18,23,0.36651245763594814,0.4879152632145384
Nodobryoria abbreviata,0,2,2,1.0,1.0
Nogopterium gracile,2,0,2,0.0209561639230412,0.01499159650771353
Nola minna,0,3,3,1.0,1.0
Nolina parryi,0,5,5,1.0,0.7760428250025136
Nomophila nearctica,0,2,2,1.0,1.0
Normandina pulchella,0,1,1,1.0,1.0
Nostoc parmelioides,2,25,27,0.41609323465062054,0.4410007741051609
Notemigonus crysoleucas,0,4,4,1.0,0.9105509465652237
Notholithocarpus densiflorus,52,66,118,9.8039622391416e-15,2.1107841501506082e-19
Notodonta pacifica,0,1,1,1.0,1.0
Notonecta kirbyi,2,4,6,0.21128172197002185,0.4637992200137968
Nucifraga columbiana,13,380,393,2.59939725422178e-13,4.75555332399852e-10
Numenius americanus,0,1,1,1.0,1.0
Nuphar polysepala,0,67,67,6.67329277773998e-05,0.001400350730518439
Nycticorax nycticorax,0,2,2,1.0,1.0
Nyctoporis carinata,1,6,7,1.0,1.0
Nyctoporis sponsa,1,0,1,0.14476460320460613,0.3126936942061339
Nymphaea odorata,2,1,3,0.056801432979852025,0.0803492820202322
Nymphalis antiopa,12,209,221,3.201115039053054e-05,0.00019251264733352886
Nymphalis californica,44,421,465,0.001498444834796313,0.002607994181098383
Obba rivulosa,0,1,1,1.0,1.0
Oberea quadricallosa,1,1,2,0.2685730424867646,0.6723203844978234
Occidryas anicia,0,2,2,1.0,1.0
Occidryas chalcedona,25,76,101,0.006502730408418013,0.005200563264047662
Occidryas editha,7,78,85,0.12182945255811789,0.13847259830223907
Ochlodes agricola,1,2,3,0.3744588472376553,0.9141432822130974
Ochlodes sylvanoides,9,78,87,0.3591155806583479,0.345632454933554
Ochotona princeps,2,150,152,2.5218564968017908e-08,6.866130034207082e-06
Octoglena anura,0,1,1,1.0,1.0
Octoglena sierra,3,1,4,0.010816792675262966,0.00633924523846032
Octogomphus specularis,17,41,58,0.0040137940124242155,0.002490275124881287
Ocypus olens,0,1,1,1.0,1.0
Odocoileus hemionus,558,1410,1968,2.870687594389188e-57,5.779539045879444e-69
Odonteus obesus,0,5,5,1.0,0.7760428250025136
Odontomyia cincta,1,0,1,0.14476460320460613,0.3126936942061339
Odontostomum hartwegii,4,0,4,0.00043910829886184923,3.314336839661014e-05
Oecanthus californicus,0,8,8,0.6124215574698968,0.5084255632839996
Oecanthus quadripunctatus,0,1,1,1.0,1.0
Oedaleonotus orientis,0,1,1,1.0,1.0
Oemleria cerasiformis,5,1,6,0.00033535930364562256,2.5155693289996723e-05
Oeneis chryxus,0,17,17,0.15747128520432685,0.17645428752866515
Oeneis ivallda,0,1,1,1.0,1.0
Oeneis nevadensis,0,11,11,0.38449278358904854,0.3492157200022511
Oenothera avita,1,0,1,0.14476460320460613,0.3126936942061339
Oenothera californica,0,1,1,1.0,1.0
Oenothera cespitosa,4,8,12,0.08293252313214843,0.1480937371178578
Oenothera elata,2,24,26,0.5732761753112863,0.4811289201701078
Oenothera primiveris,0,1,1,1.0,1.0
Oenothera speciosa,0,2,2,1.0,1.0
Oenothera xylocarpa,1,8,9,1.0,1.0
Okanagana arctostaphylae,5,0,5,6.355973818199171e-05,1.5903757301150513e-06
Okanagana bella,0,10,10,0.3757244358299004,0.39438447212016514
Okanagana cruentifera,0,3,3,1.0,1.0
Okanagana ferrugomaculata,0,1,1,1.0,1.0
Okanagana magnifica,0,3,3,1.0,1.0
Okanagana nigrodorsata,0,19,19,0.09746384240092232,0.14226189947649115
Okanagana occidentalis,0,1,1,1.0,1.0
Okanagana oregona,0,2,2,1.0,1.0
Okanagana ornata,0,1,1,1.0,1.0
Okanagana tristis,2,5,7,0.2688137426846044,0.6011437582684053
Okanagana vandykei,0,4,4,1.0,0.9105509465652237
Okanagana villosa,0,1,1,1.0,1.0
Olea europaea,2,0,2,0.0209561639230412,0.01499159650771353
Oligia rampartensis,0,1,1,1.0,1.0
Oligia violacea,4,0,4,0.00043910829886184923,3.314336839661014e-05
Oligotrophus betheli,0,3,3,1.0,1.0
Olios giganteus,1,1,2,0.2685730424867646,0.6723203844978234
Olla v-nigrum,6,2,8,0.00019772693610894856,1.2839299064071593e-05
Omoglymmius hamatus,0,1,1,1.0,1.0
Omphalodina chrysoleuca,1,3,4,0.4650164385481151,1.0
Omphalotus olivascens,28,10,38,3.2778703102673194e-16,3.550297645833046e-24
Omus californicus,8,93,101,0.06518567166235485,0.08336822096427055
Oncopeltus fasciatus,4,0,4,0.00043910829886184923,3.314336839661014e-05
Oncorhynchus aguabonita,6,38,44,1.0,1.0
Oncorhynchus henshawi,0,19,19,0.09746384240092232,0.14226189947649115
Oncorhynchus mykiss,9,150,159,0.0006580575290496058,0.0023044581463852474
Oncorhynchus nerka,0,27,27,0.025685714280551247,0.06225570614991151
Ondatra zibethicus,0,2,2,1.0,1.0
Onopordum acanthium,0,1,1,1.0,1.0
Ophioglossum pusillum,0,2,2,1.0,1.0
Ophiogomphus bison,0,5,5,1.0,0.7760428250025136
Ophiogomphus morrisoni,0,2,2,1.0,1.0
Ophiogomphus occidentis,1,0,1,0.14476460320460613,0.3126936942061339
Opuntia basilaris,18,57,75,0.030726975618563405,0.029234046548667608
Opuntia polyacantha,16,121,137,0.396713676550037,0.4182252147616784
Oreocarya abortiva,0,3,3,1.0,1.0
Oreocarya confertiflora,4,19,23,0.764526906780843,0.9195557130253361
Oreocarya crymophila,0,2,2,1.0,1.0
Oreocarya flavoculata,1,48,49,0.007396103017052419,0.023132543109155013
Oreocarya hoffmannii,1,12,13,0.7073310728950297,0.7633631983104203
Oreocarya humilis,0,4,4,1.0,0.9105509465652237
Oreocarya nubigena,0,1,1,1.0,1.0
Oreocarya roosiorum,0,1,1,1.0,1.0
Oreonana clementis,1,15,16,0.4958553183213633,0.5619415773454699
Oreonana purpurascens,1,7,8,1.0,1.0
Oreortyx pictus,13,121,134,0.13940112386481063,0.1474392819617341
Oreoscoptes montanus,0,2,2,1.0,1.0
Oreostemma alpigenum,0,42,42,0.0030925703143636907,0.014392358240800228
Orgyia pseudotsugata,2,66,68,0.0030455459645246374,0.011357475266838437
Orgyia vetusta,4,5,9,0.030121806187693938,0.03739180706614353
Orobittacus obscurus,0,1,1,1.0,1.0
Orochaenactis thysanocarpha,2,28,30,0.303117213659443,0.3389041172310913
Orohermes crepusculus,0,15,15,0.14994170356869613,0.21998124924271661
Orphilus subnitidus,1,5,6,1.0,1.0
Orthilia secunda,1,179,180,3.565234513559287e-11,1.945825611893053e-07
Orthocarpus cuspidatus,0,54,54,0.0003367115756713232,0.004649855763319928
Orthodicranum tauricum,0,1,1,1.0,1.0
Ortholeptura valida,1,45,46,0.010959758975598914,0.030609773837542827
Orthosia ferrigera,0,1,1,1.0,1.0
Orthosia hibisci,0,1,1,1.0,1.0
Orthosia mys,1,4,5,0.5424646889787644,1.0
Orthosia pulchella,0,3,3,1.0,1.0
Oskoron spinosus,0,2,2,1.0,1.0
Osmia coloradensis,0,1,1,1.0,1.0
Osmia lignaria,0,1,1,1.0,1.0
Osmia montana,0,1,1,1.0,1.0
Osmorhiza berteroi,4,52,56,0.1311118445894615,0.17068972803426075
Osmorhiza brachypoda,0,3,3,1.0,1.0
Osmorhiza occidentalis,0,39,39,0.0046877939621657125,0.019179555698833974
Otiorhynchus sulcatus,0,1,1,1.0,1.0
Otospermophilus beecheyi,99,785,884,0.004683456432756049,0.006378579792616843
Ovis aries,0,2,2,1.0,1.0
Ovis canadensis,5,8,13,0.029720034996664528,0.03904543059057355
Oxalis articulata,2,0,2,0.0209561639230412,0.01499159650771353
Oxalis pes-caprae,1,1,2,0.2685730424867646,0.6723203844978234
Oxalis triangularis,1,0,1,0.14476460320460613,0.3126936942061339
Oxidus gracilis,1,3,4,0.4650164385481151,1.0
Oxychilus draparnaudi,1,0,1,0.14476460320460613,0.3126936942061339
Oxyopes salticus,5,0,5,6.355973818199171e-05,1.5903757301150513e-06
Oxyopes scalaris,2,0,2,0.0209561639230412,0.01499159650771353
Oxypolis occidentalis,0,2,2,1.0,1.0
Oxyptilus delawaricus,0,1,1,1.0,1.0
Oxyria digyna,0,30,30,0.016694385851981373,0.04613372038512279
Oxytheca dendroidea,0,9,9,0.37460992252836506,0.4468858706621094
Oxytheca perfoliata,0,1,1,1.0,1.0
Oxytheca watsonii,2,0,2,0.0209561639230412,0.01499159650771353
Oxytropis deflexa,1,0,1,0.14476460320460613,0.3126936942061339
Oxytropis parryi,1,1,2,0.2685730424867646,0.6723203844978234
Oxyura jamaicensis,1,7,8,1.0,1.0
Pachycudonia spathulata,6,0,6,9.199825086801498e-06,7.715317253706965e-08
Pachydiplax longipennis,20,13,33,1.3616913127412148e-09,3.230668850801781e-13
Pachyrhinus californicus,0,2,2,1.0,1.0
Pachyrhinus cinereus,0,1,1,1.0,1.0
Pachyrhinus elegans,0,6,6,0.6025804396089913,0.6688993551184468
Pachysphinx occidentalis,0,1,1,1.0,1.0
Pachyta armata,0,4,4,1.0,0.9105509465652237
Pacifastacus leniusculus,10,49,59,0.5781382181904063,0.722709277041516
Packera cana,6,16,22,0.11926992136640324,0.16064992252718743
Packera eurycephala,5,3,8,0.0024244129099057063,0.0007850786162003298
Packera indecora,0,3,3,1.0,1.0
Packera layneae,1,0,1,0.14476460320460613,0.3126936942061339
Packera multilobata,1,29,30,0.11442317027725885,0.1401452618300091
Packera pauciflora,0,9,9,0.37460992252836506,0.4468858706621094
Packera pseudaurea,0,2,2,1.0,1.0
Packera streptanthifolia,0,15,15,0.14994170356869613,0.21998124924271661
Packera subnuda,0,3,3,1.0,1.0
Packera werneriifolia,0,1,1,1.0,1.0
Pactopus hornii,0,1,1,1.0,1.0
Paeonia brownii,1,348,349,2.18263914305754e-22,8.367285736848302e-14
Paeromopus angusticeps,12,8,20,3.395938846443072e-06,4.538320717941858e-08
Paeromopus paniculus,0,5,5,1.0,0.7760428250025136
Pagaronia furcata,0,1,1,1.0,1.0
Palmodes praestans,0,13,13,0.23752623411074927,0.27601031745794824
Paltothemis lineatipes,3,0,3,0.0030335293929702875,0.000700171082788584
Panaeolina foenisecii,1,2,3,0.3744588472376553,0.9141432822130974
Pandion haliaetus,12,115,127,0.1288452364141363,0.13764218586724383
Panellus mitis,3,2,5,0.02413002787627292,0.023975245305455268
Panellus stipticus,5,1,6,0.00033535930364562256,2.5155693289996723e-05
Panicum capillare,0,2,2,1.0,1.0
Panicum virgatum,0,1,1,1.0,1.0
Panorpodes colei,0,1,1,1.0,1.0
Pantala flavescens,1,0,1,0.14476460320460613,0.3126936942061339
Pantala hymenaea,3,4,7,0.0674516701814297,0.11027569540283454
Panthea virginarius,0,11,11,0.38449278358904854,0.3492157200022511
Panus conchatus,3,0,3,0.0030335293929702875,0.000700171082788584
Papaver rhoeas,1,0,1,0.14476460320460613,0.3126936942061339
Papilio eurymedon,63,461,524,0.11989764913242251,0.12449813228688761
Papilio indra,1,17,18,0.5002083905620196,0.4588452058316618
Papilio multicaudata,4,5,9,0.030121806187693938,0.03739180706614353
Papilio rutulus,40,175,215,0.09831345700359365,0.10431713791801156
Papilio zelicaon,6,91,97,0.01971982938642404,0.029486405476056667
Pappostipa speciosa,1,1,2,0.2685730424867646,0.6723203844978234
Paradejeania rutilioides,0,1,1,1.0,1.0
Paradiplosis tumifex,0,2,2,1.0,1.0
Paralepista flaccida,0,1,1,1.0,1.0
Paranaemia vittigera,0,1,1,1.0,1.0
Paranoplium gracile,0,1,1,1.0,1.0
Paranthrene robiniae,1,0,1,0.14476460320460613,0.3126936942061339
Paraplatyptilia fragilis,0,1,1,1.0,1.0
Parasemia plantaginis,0,17,17,0.15747128520432685,0.17645428752866515
Parasola conopilea,1,0,1,0.14476460320460613,0.3126936942061339
Parasola hercules,0,1,1,1.0,1.0
Parasola plicatilis,0,1,1,1.0,1.0
Parasyrphus melanderi,0,2,2,1.0,1.0
Paratettix aztecus,1,0,1,0.14476460320460613,0.3126936942061339
Parcipromus gigantoarboricolus,0,7,7,0.6034645370398923,0.5813304975648097
Parcoblatta americana,0,6,6,0.6025804396089913,0.6688993551184468
Parkesia noveboracensis,0,1,1,1.0,1.0
Parmelia sulcata,1,0,1,0.14476460320460613,0.3126936942061339
Parnassia fimbriata,0,3,3,1.0,1.0
Parnassia palustris,0,108,108,6.605745005514061e-08,3.472663377260585e-05
Parnassius clodius,7,255,262,1.8511245858303642e-10,8.984297030895233e-08
Parnassius smintheus,1,1,2,0.2685730424867646,0.6723203844978234
Parthenocissus quinquefolia,1,0,1,0.14476460320460613,0.3126936942061339
Paruroctonus boreus,7,19,26,0.0885128788538413,0.1272300084150944
Paruroctonus silvestrii,4,1,5,0.0019413025415773043,0.00041787713651955216
Paspalum dilatatum,1,0,1,0.14476460320460613,0.3126936942061339
Passer domesticus,4,3,7,0.0106471288054473,0.007559096939159896
Passerculus sandwichensis,2,5,7,0.2688137426846044,0.6011437582684053
Passerella iliaca,10,229,239,4.42767581613039e-07,9.29908596436784e-06
Passerella megarhyncha,0,41,41,0.0029382927234686395,0.015834078394456372
Passerella schistacea,0,1,1,1.0,1.0
Passerina amoena,7,83,90,0.0724712070622795,0.09758650697120469
Passerina caerulea,0,3,3,1.0,1.0
Passerina cyanea,0,2,2,1.0,1.0
Patagioenas fasciata,24,54,78,0.0002601109233930154,8.517247944515498e-05
Pavo cristatus,1,1,2,0.2685730424867646,0.6723203844978234
Paxillus involutus,1,0,1,0.14476460320460613,0.3126936942061339
Paxistima myrsinites,4,5,9,0.030121806187693938,0.03739180706614353
Pectiantia pentandra,0,21,21,0.06152025756350138,0.11517086832716916
Pectocarya pusilla,3,0,3,0.0030335293929702875,0.000700171082788584
Pediacus stephani,0,1,1,1.0,1.0
Pedicularis attollens,1,277,278,1.1192978187156384e-17,3.875535468438061e-11
Pedicularis crenulata,0,2,2,1.0,1.0
Pedicularis densiflora,41,15,56,6.265165978243834e-23,8.617358766484142e-35
Pedicularis groenlandica,6,238,244,4.0176041299409043e-10,1.5438485398515404e-07
Pedicularis racemosa,0,18,18,0.0958116006335464,0.1583481410858158
Pedicularis semibarbata,10,367,377,1.2019937197581375e-14,1.0634046829814672e-10
Pekania pennanti,1,0,1,0.14476460320460613,0.3126936942061339
Pelecanus erythrorhynchos,1,24,25,0.2476906644158463,0.22836298286850215
Pelecanus occidentalis,0,1,1,1.0,1.0
Pelegrina aeneola,2,8,10,0.6456440117183423,0.9624710515030661
Pelegrina balia,1,0,1,0.14476460320460613,0.3126936942061339
Pellaea andromedifolia,13,2,15,9.627277280701697e-10,3.4713082214925285e-14
Pellaea brachyptera,0,9,9,0.37460992252836506,0.4468858706621094
Pellaea breweri,1,40,41,0.02421393884327443,0.048973319116519747
Pellaea bridgesii,2,252,254,7.78971849728426e-15,9.648322247543137e-10
Pellaea mucronata,28,44,72,3.2519530899013477e-07,1.0608654711704169e-08
Pelochrista crambitana,0,1,1,1.0,1.0
Peltigera collina,1,4,5,0.5424646889787644,1.0
Peltigera gowardii,0,6,6,0.6025804396089913,0.6688993551184468
Peltigera leucophlebia,0,1,1,1.0,1.0
Peltigera venosa,2,2,4,0.10278607328810296,0.1906437976216683
Peltis pippingskoeldi,0,5,5,1.0,0.7760428250025136
Pemphigus obesinymphae,0,1,1,1.0,1.0
Pemphigus populi-globuli,0,5,5,1.0,0.7760428250025136
Penicillium vulpinum,2,0,2,0.0209561639230412,0.01499159650771353
Peniophora exima,0,1,1,1.0,1.0
Pennisetia marginatum,1,0,1,0.14476460320460613,0.3126936942061339
Penstemon azureus,3,92,95,0.0006202654763659428,0.0027877015587676433
Penstemon caesius,5,17,22,0.23656815502062878,0.42548805606152795
Penstemon cinicola,0,1,1,1.0,1.0
Penstemon davidsonii,0,47,47,0.0012664264058445166,0.008959167191137872
Penstemon deustus,1,100,101,5.632552746645763e-06,0.0002060263401404734
Penstemon eatonii,0,18,18,0.0958116006335464,0.1583481410858158
Penstemon floridus,2,13,15,1.0,1.0
Penstemon fruticiformis,1,0,1,0.14476460320460613,0.3126936942061339
Penstemon gracilentus,0,86,86,3.3333992826341014e-06,0.0002493329886354844
Penstemon grinnellii,3,9,12,0.3994183286503844,0.5314104390489738
Penstemon heterodoxus,1,134,135,2.55436854943786e-08,1.0105351513400026e-05
Penstemon heterophyllus,4,18,22,0.5484256757371997,0.8485385690675789
Penstemon humilis,0,1,1,1.0,1.0
Penstemon incertus,3,2,5,0.02413002787627292,0.023975245305455268
Penstemon laetus,41,356,397,0.018232801091444747,0.022582949821093327
Penstemon neotericus,0,1,1,1.0,1.0
Penstemon newberryi,29,1482,1511,1.223734026766033e-64,7.383931676822259e-44
Penstemon palmeri,0,2,2,1.0,1.0
Penstemon papillatus,0,4,4,1.0,0.9105509465652237
Penstemon patens,7,63,70,0.3938141699319959,0.3709326898479315
Penstemon personatus,0,14,14,0.24486350799097997,0.24618548812479032
Penstemon procerus,0,4,4,1.0,0.9105509465652237
Penstemon roezlii,0,18,18,0.0958116006335464,0.1583481410858158
Penstemon rostriflorus,22,255,277,0.0011303701867734495,0.0026345047230894813
Penstemon rydbergii,1,137,138,1.6963870791053996e-08,7.756657254447853e-06
Penstemon scapoides,4,95,99,0.0014323588404834883,0.004970177454862934
Penstemon speciosus,15,185,200,0.003405848214681123,0.006832983693780403
Penstemon spectabilis,0,1,1,1.0,1.0
Penstemon strictus,0,29,29,0.016473723171988544,0.05095618599691111
Penstemon subglaber,0,1,1,1.0,1.0
Pentagramma pallida,2,0,2,0.0209561639230412,0.01499159650771353
Pentagramma triangularis,79,24,103,1.9968113661831907e-45,5.738948175363677e-71
Pepsis thisbe,1,2,3,0.3744588472376553,0.9141432822130974
Pericome caudata,1,0,1,0.14476460320460613,0.3126936942061339
Perideridia bolanderi,0,1,1,1.0,1.0
Perideridia gairdneri,0,3,3,1.0,1.0
Perideridia kelloggii,0,1,1,1.0,1.0
Perideridia lemmonii,0,1,1,1.0,1.0
Perideridia parishii,0,4,4,1.0,0.9105509465652237
Peridroma saucia,0,2,2,1.0,1.0
Perigonica pectinata,0,1,1,1.0,1.0
Perilachnea hemisphaerioides,0,2,2,1.0,1.0
Periploca ceanothiella,0,1,1,1.0,1.0
Perizoma costiguttata,0,1,1,1.0,1.0
Perizoma custodiata,0,1,1,1.0,1.0
Perizoma oxygramma,0,2,2,1.0,1.0
Pero behrensaria,0,5,5,1.0,0.7760428250025136
Pero occidentalis,0,1,1,1.0,1.0
Peromyscus boylii,1,0,1,0.14476460320460613,0.3126936942061339
Peromyscus maniculatus,1,11,12,1.0,0.845714857147599
Peromyscus truei,1,1,2,0.2685730424867646,0.6723203844978234
Perrotia flammea,0,1,1,1.0,1.0
Persicaria amphibia,1,10,11,1.0,0.9368824658167821
Persicaria hydropiper,0,1,1,1.0,1.0
Persicaria lapathifolia,0,4,4,1.0,0.9105509465652237
Persicaria maculosa,3,2,5,0.02413002787627292,0.023975245305455268
Petrochelidon pyrrhonota,2,16,18,1.0,0.9435167712853587
Petrophila confusalis,0,3,3,1.0,1.0
Petrophytum caespitosum,1,38,39,0.036658892545794367,0.059174927856222845
Petrorhagia dubia,24,6,30,1.7242689589951008e-15,2.7622354425617334e-23
Peziza echinospora,0,2,2,1.0,1.0
Peziza varia,0,2,2,1.0,1.0
Phacelia affinis,0,2,2,1.0,1.0
Phacelia austromontana,0,15,15,0.14994170356869613,0.21998124924271661
Phacelia barnebyana,0,2,2,1.0,1.0
Phacelia bicolor,1,17,18,0.5002083905620196,0.4588452058316618
Phacelia campanularia,0,1,1,1.0,1.0
Phacelia cicutaria,6,1,7,5.640935459925577e-05,1.4388133744720056e-06
Phacelia congdonii,1,0,1,0.14476460320460613,0.3126936942061339
Phacelia crenulata,1,1,2,0.2685730424867646,0.6723203844978234
Phacelia cryptantha,1,0,1,0.14476460320460613,0.3126936942061339
Phacelia curvipes,3,13,16,0.7183433205274137,0.8961140145401856
Phacelia davidsonii,5,2,7,0.0010327341762908842,0.00018014051424031924
Phacelia distans,4,9,13,0.10658251785953915,0.20215021085988086
Phacelia egena,0,2,2,1.0,1.0
Phacelia eisenii,0,20,20,0.10203106758234803,0.12794167189413608
Phacelia exilis,8,5,13,0.00012493599837919194,9.489826548441195e-06
Phacelia fremontii,8,31,39,0.25928074184383876,0.39872795976641207
Phacelia hastata,1,42,43,0.01622675096907854,0.04056016775761201
Phacelia heterophylla,4,20,24,0.7698462495816365,0.9881272847523668
Phacelia humilis,6,85,91,0.03533493535453028,0.04673695313856465
Phacelia hydrophylloides,1,215,216,1.6738758463341336e-13,8.424254369672108e-09
Phacelia imbricata,1,4,5,0.5424646889787644,1.0
Phacelia inyoensis,1,6,7,1.0,1.0
Phacelia linearis,1,1,2,0.2685730424867646,0.6723203844978234
Phacelia marcescens,1,22,23,0.23832747917939356,0.27824213268427256
Phacelia monoensis,0,1,1,1.0,1.0
Phacelia mutabilis,0,9,9,0.37460992252836506,0.4468858706621094
Phacelia nashiana,3,6,9,0.12984024511270734,0.25675213762300036
Phacelia novenmillensis,1,9,10,1.0,1.0
Phacelia orogenes,7,1,8,9.303494096827296e-06,7.976934310518629e-08
Phacelia peirsoniana,3,8,11,0.2054644031680506,0.4367258119699784
Phacelia procera,0,8,8,0.6124215574698968,0.5084255632839996
Phacelia purpusii,4,23,27,1.0,1.0
Phacelia quickii,5,61,66,0.15831798197104757,0.15601566219609678
Phacelia racemosa,0,19,19,0.09746384240092232,0.14226189947649115
Phacelia ramosissima,4,56,60,0.09778239725812857,0.12452845496445147
Phacelia rotundifolia,0,2,2,1.0,1.0
Phacelia stebbinsii,0,9,9,0.37460992252836506,0.4468858706621094
Phacelia tanacetifolia,0,3,3,1.0,1.0
Phacelia vallicola,4,4,8,0.01886984470142184,0.01861366248431812
Phacelia vallis-mortae,0,36,36,0.007132175646578675,0.02562119468214464
Phaenops gentilis,0,2,2,1.0,1.0
Phaeoclavulina curta,0,1,1,1.0,1.0
Phaeocollybia ammiratii,2,0,2,0.0209561639230412,0.01499159650771353
Phaeocollybia attenuata,0,1,1,1.0,1.0
Phaeocollybia olivacea,4,1,5,0.0019413025415773043,0.00041787713651955216
Phaeolus schweinitzii,14,69,83,0.5318900947716616,0.6432203390775209
Phaeomarasmius erinaceus,1,0,1,0.14476460320460613,0.3126936942061339
Phaeophyscia endococcina,0,1,1,1.0,1.0
Phaeotremella foliacea,0,1,1,1.0,1.0
Phaeotremella frondosa,1,0,1,0.14476460320460613,0.3126936942061339
Phaeoura aetha,0,5,5,1.0,0.7760428250025136
Phaeoura mexicanaria,0,1,1,1.0,1.0
Phainopepla nitens,2,4,6,0.21128172197002185,0.4637992200137968
Phalacrocorax auritus,2,3,5,0.15522343689242213,0.32387652224382535
Phalacroseris bolanderi,0,1,1,1.0,1.0
Phalaenoptilus nuttallii,1,7,8,1.0,1.0
Phalangium opilio,0,1,1,1.0,1.0
Phalaris aquatica,1,0,1,0.14476460320460613,0.3126936942061339
Phalaris arundinacea,1,1,2,0.2685730424867646,0.6723203844978234
Phalaropus lobatus,0,1,1,1.0,1.0
Phalaropus tricolor,0,2,2,1.0,1.0
Phanacis hypochoeridis,1,0,1,0.14476460320460613,0.3126936942061339
Phanias monticola,0,2,2,1.0,1.0
Phanogomphus kurilis,0,6,6,0.6025804396089913,0.6688993551184468
Phasianus colchicus,0,1,1,1.0,1.0
Phellinus gilvus,0,1,1,1.0,1.0
Phellinus igniarius,0,2,2,1.0,1.0
Phellinus tremulae,0,2,2,1.0,1.0
Phellodon melaleucus,1,0,1,0.14476460320460613,0.3126936942061339
Phellopsis porcata,0,10,10,0.3757244358299004,0.39438447212016514
Pheosia rimosa,0,13,13,0.23752623411074927,0.27601031745794824
Pherne placeraria,0,1,1,1.0,1.0
Pherne subpunctata,1,0,1,0.14476460320460613,0.3126936942061339
Pheucticus ludovicianus,0,1,1,1.0,1.0
Pheucticus melanocephalus,60,188,248,5.94416057029426e-05,2.0312674558989407e-05
Phidippus audax,0,2,2,1.0,1.0
Phidippus californicus,0,3,3,1.0,1.0
Phidippus comatus,2,0,2,0.0209561639230412,0.01499159650771353
Phidippus johnsoni,9,35,44,0.28030911924177304,0.36132028285312645
Phigalia plumogeraria,2,1,3,0.056801432979852025,0.0803492820202322
Philadelphus lewisii,21,17,38,5.449818690264297e-09,4.655326128594878e-12
Philadelphus microphyllus,0,1,1,1.0,1.0
Philaenus spumarius,0,7,7,0.6034645370398923,0.5813304975648097
Philonotis fontana,0,1,1,1.0,1.0
Philotes intermedia,0,3,3,1.0,1.0
Philotes pallescens,0,3,3,1.0,1.0
Philotes sonorensis,19,35,54,0.00012188219238345048,3.59477290283679e-05
Philotiella speciosa,0,2,2,1.0,1.0
Phlebia radiata,1,0,1,0.14476460320460613,0.3126936942061339
Phlebia tremellosa,1,1,2,0.2685730424867646,0.6723203844978234
Phlegmacium balteatum,0,1,1,1.0,1.0
Phlegmacium calyptratum,0,2,2,1.0,1.0
Phlegmacium ponderosum,11,1,12,6.080567969696642e-09,6.507654316294432e-13
Phlegmacium subfoetens,1,0,1,0.14476460320460613,0.3126936942061339
Phlegmacium subfoetidum,1,0,1,0.14476460320460613,0.3126936942061339
Phlegmacium sublilacinum,0,2,2,1.0,1.0
Phlegmacium subolivascens,0,1,1,1.0,1.0
Phlegmacium variosimile,0,1,1,1.0,1.0
Phleum alpinum,1,26,27,0.1664908585838914,0.1876753474441988
Phleum pratense,0,52,52,0.0005244679655933337,0.005603592816712951
Phloeodes diabolicus,3,1,4,0.010816792675262966,0.00633924523846032
Phloeomana speirea,1,4,5,0.5424646889787644,1.0
Phlox condensata,1,19,20,0.3447987554750399,0.37521694522958526
Phlox diffusa,8,399,407,5.7516183773098706e-18,1.1600601035319066e-12
Phlox dispersa,4,1,5,0.0019413025415773043,0.00041787713651955216
Phlox gracilis,16,99,115,1.0,0.9687185698627128
Phlox hoodii,0,2,2,1.0,1.0
Phlox longifolia,1,74,75,0.00020565489411432332,0.0021308764093209637
Phlox speciosa,30,28,58,2.8105463902535582e-11,3.3667550057264896e-15
Phlox subulata,1,1,2,0.2685730424867646,0.6723203844978234
Phlyctis argena,0,2,2,1.0,1.0
Phobolosia anfracta,1,15,16,0.4958553183213633,0.5619415773454699
Phoenicaulis cheiranthoides,4,50,54,0.17509244908717747,0.19944547479472113
Pholcophora americana,0,3,3,1.0,1.0
Pholcus phalangioides,1,2,3,0.3744588472376553,0.9141432822130974
Pholiota alniphila,0,1,1,1.0,1.0
Pholiota aurivella,1,64,65,0.0010868724805583544,0.005292122215611074
Pholiota brunnescens,2,0,2,0.0209561639230412,0.01499159650771353
Pholiota carbonaria,0,10,10,0.3757244358299004,0.39438447212016514
Pholiota decorata,1,0,1,0.14476460320460613,0.3126936942061339
Pholiota ferrugineolutescens,0,1,1,1.0,1.0
Pholiota flammans,0,1,1,1.0,1.0
Pholiota foedata,0,1,1,1.0,1.0
Pholiota lignicola,0,21,21,0.06152025756350138,0.11517086832716916
Pholiota molesta,0,7,7,0.6034645370398923,0.5813304975648097
Pholiota nubigena,0,19,19,0.09746384240092232,0.14226189947649115
Pholiota olivaceophylla,0,5,5,1.0,0.7760428250025136
Pholiota spumosa,0,5,5,1.0,0.7760428250025136
Pholiota terrestris,1,1,2,0.2685730424867646,0.6723203844978234
Pholiota velaglutinosa,1,0,1,0.14476460320460613,0.3126936942061339
Pholisora catullus,1,1,2,0.2685730424867646,0.6723203844978234
Pholistoma auritum,2,4,6,0.21128172197002185,0.4637992200137968
Phoracantha recurva,1,0,1,0.14476460320460613,0.3126936942061339
Phoradendron bolleanum,0,2,2,1.0,1.0
Phoradendron juniperinum,1,20,21,0.3485544901265487,0.3394968187912247
Phoradendron leucarpum,2,1,3,0.056801432979852025,0.0803492820202322
Phoradendron libocedri,0,2,2,1.0,1.0
Phoradendron pauciflorum,0,1,1,1.0,1.0
Phormia regina,0,1,1,1.0,1.0
Phortica picta,1,0,1,0.14476460320460613,0.3126936942061339
Photinia serratifolia,1,1,2,0.2685730424867646,0.6723203844978234
Photinus californica,13,10,23,3.3256794417084487e-06,5.488600529486964e-08
Phragmidium mucronatum,0,1,1,1.0,1.0
Phragmidium rosae-multiflorae,0,1,1,1.0,1.0
Phragmidium tuberculatum,0,1,1,1.0,1.0
Phragmites australis,1,0,1,0.14476460320460613,0.3126936942061339
Phrynosoma blainvillii,11,23,34,0.006639178758744984,0.006548772898099039
Phrynosoma platyrhinos,0,1,1,1.0,1.0
Phtheochroa aegrana,0,1,1,1.0,1.0
Phyciodes montana,0,16,16,0.15161267346782015,0.19687992504129675
Phyciodes orseis,0,13,13,0.23752623411074927,0.27601031745794824
Phyciodes tharos,4,148,152,2.3004737100951387e-06,5.4235104833079004e-05
Phyllocnistis populiella,0,10,10,0.3757244358299004,0.39438447212016514
Phyllodesma americana,0,9,9,0.37460992252836506,0.4468858706621094
Phyllodoce breweri,2,599,601,1.0868475367699436e-37,1.0070101653844097e-22
Phyllonorycter manzanita,1,1,2,0.2685730424867646,0.6723203844978234
Phylloporus arenicola,4,4,8,0.01886984470142184,0.01861366248431812
Phyllorhynchus decurtatus,0,1,1,1.0,1.0
Phylloscopus inornatus,0,2,2,1.0,1.0
Phylloscypha phyllogena,0,1,1,1.0,1.0
Phyllotopsis nidulans,35,81,116,1.4670723920603821e-05,2.9557139056793144e-06
Phylloxera reticulata,0,1,1,1.0,1.0
Phymatodes grandis,0,1,1,1.0,1.0
Phymatodes vulneratus,0,1,1,1.0,1.0
Phymatopus hectoides,0,4,4,1.0,0.9105509465652237
Physaria kingii,0,23,23,0.06652127337221461,0.09355974164186621
Physarum alpinum,0,1,1,1.0,1.0
Physcia dubia,0,1,1,1.0,1.0
Physematium scopulinum,0,2,2,1.0,1.0
Physocarpus alternans,0,1,1,1.0,1.0
Physocarpus capitatus,6,9,15,0.014202389485018597,0.014582554383236133
Physocephala texana,0,1,1,1.0,1.0
Phytolacca americana,36,6,42,1.2602757428581787e-24,4.3328110692340714e-38
Pica hudsonia,1,6,7,1.0,1.0
Picipes badius,1,4,5,0.5424646889787644,1.0
Picipes submelanopus,0,1,1,1.0,1.0
Pickeringia montana,4,4,8,0.01886984470142184,0.01861366248431812
Picoides arcticus,0,119,119,1.2022938269995059e-08,1.3057338072175156e-05
Pieris marginalis,7,6,13,0.0010192335799894875,0.0002724004392891465
Pieris rapae,6,21,27,0.268604493738199,0.3840576019500902
Pinicola enucleator,0,68,68,3.961724711579205e-05,0.0012778375388509272
Pinus albicaulis,1,140,141,1.1291943149146909e-08,5.955033273332289e-06
Pinus attenuata,3,5,8,0.09660076546782431,0.17754400284199642
Pinus balfouriana,24,129,153,0.6459908926520139,0.7561550917146073
Pinus contorta,13,612,625,1.7078289762708148e-26,1.871875455351623e-18
Pinus coulteri,4,0,4,0.00043910829886184923,3.314336839661014e-05
Pinus flexilis,3,47,50,0.10619445843759517,0.1329256500414299
Pinus jeffreyi,12,305,317,6.520818436984759e-10,9.598646165943162e-08
Pinus lambertiana,62,577,639,0.0003769314976029294,0.0007279507755531945
Pinus longaeva,3,320,323,6.141584637235272e-18,7.57837031129774e-12
Pinus monophylla,47,176,223,0.007417380645035698,0.0067826127035818164
Pinus monticola,1,201,202,1.3041427319915762e-12,2.8516547919064246e-08
Pinus ponderosa,94,173,267,2.6738884346580822e-17,1.3474148374019605e-21
Pinus sabiniana,42,6,48,2.6848263831119805e-29,1.3087897968856753e-45
Pinus sylvestris,0,1,1,1.0,1.0
Pipilo chlorurus,3,199,202,2.944977568847786e-10,2.602398379853404e-07
Pipilo maculatus,74,73,147,1.127494282854448e-24,1.7845052531879059e-34
Piptatheropsis micrantha,0,2,2,1.0,1.0
Piranga ludoviciana,31,435,466,2.1601708897564394e-07,2.1382613529723755e-06
Piranga rubra,1,1,2,0.2685730424867646,0.6723203844978234
Pirex concentricus,2,0,2,0.0209561639230412,0.01499159650771353
Pisolithus arhizus,2,1,3,0.056801432979852025,0.0803492820202322
Pisolithus tinctorius,5,1,6,0.00033535930364562256,2.5155693289996723e-05
Pistacia chinensis,1,0,1,0.14476460320460613,0.3126936942061339
Pithya vulgaris,0,4,4,1.0,0.9105509465652237
Pituophis catenifer,47,58,105,8.949126193626458e-14,3.842920517477926e-18
Plagiobothrys nothofulvus,5,1,6,0.00033535930364562256,2.5155693289996723e-05
Plagiobothrys scouleri,0,2,2,1.0,1.0
Plagiobothrys torreyi,2,2,4,0.10278607328810296,0.1906437976216683
Plagiomnium ciliare,0,1,1,1.0,1.0
Plantago coronopus,1,0,1,0.14476460320460613,0.3126936942061339
Plantago erecta,0,1,1,1.0,1.0
Plantago lanceolata,41,43,84,9.041361665539434e-14,1.4993395522914115e-18
Plantago major,2,22,24,0.5653148798484595,0.5718848303294736
Plataea trilinearia,0,5,5,1.0,0.7760428250025136
Platanthera colemanii,0,13,13,0.23752623411074927,0.27601031745794824
Platanthera dilatata,27,1132,1159,1.8156520318364538e-45,7.466321639775106e-32
Platanthera elongata,9,16,25,0.006296445034677228,0.005528959050071479
Platanthera leptopetala,3,3,6,0.0431068667335647,0.05837521372070738
Platanthera michaelii,2,0,2,0.0209561639230412,0.01499159650771353
Platanthera sparsiflora,2,195,197,4.016401064445257e-11,1.3567561645952883e-07
Platanthera tescamnis,1,10,11,1.0,0.9368824658167821
Platanthera transversa,33,80,113,7.136162273686584e-05,1.58338925777351e-05
Platanthera unalascensis,0,70,70,2.5806452682206875e-05,0.0010643241617196923
Platanthera yosemitensis,0,4,4,1.0,0.9105509465652237
Plateumaris dubia,0,1,1,1.0,1.0
Plathemis lydia,21,22,43,9.528790423684826e-08,6.110589639635963e-10
Plathemis subornata,0,2,2,1.0,1.0
Platyceroides latus,0,2,2,1.0,1.0
Platycotis vittatus,9,11,20,0.0010227815117588954,0.0003681321450721725
Platycryptus californicus,5,21,26,0.4135949053791238,0.6815753903288135
Platydracus rutilicauda,1,1,2,0.2685730424867646,0.6723203844978234
Platylyra californica,0,2,2,1.0,1.0
Platynus brunneomarginatus,0,1,1,1.0,1.0
Platypedia putnami,0,1,1,1.0,1.0
Platypedia scotti,1,0,1,0.14476460320460613,0.3126936942061339
Platystemon californicus,7,3,10,0.00010655132026942219,5.604574097560587e-06
Platystoechotes lineata,0,2,2,1.0,1.0
Plebejus fridayi,0,8,8,0.6124215574698968,0.5084255632839996
Plebulina emigdionis,0,1,1,1.0,1.0
Plectritis brachystemon,1,0,1,0.14476460320460613,0.3126936942061339
Plectritis ciliosa,3,1,4,0.010816792675262966,0.00633924523846032
Plegadis chihi,0,2,2,1.0,1.0
Pleiacanthus spinosus,1,23,24,0.24143280901572373,0.25202843593319213
Pleocoma fimbriata,8,1,9,1.5113716238966603e-06,4.3344519411722725e-09
Pleocoma hoppingi,0,7,7,0.6034645370398923,0.5813304975648097
Pleocoma rubiginosa,0,1,1,1.0,1.0
Pleocoma staff,10,5,15,5.9996598082266874e-06,7.535431692106896e-08
Pleocoma tularensis,1,0,1,0.14476460320460613,0.3126936942061339
Pleopsidium oxytonum,0,6,6,0.6025804396089913,0.6688993551184468
Pleromella opter,0,2,2,1.0,1.0
Pleromelloida cinerea,1,0,1,0.14476460320460613,0.3126936942061339
Pleromelloida conserta,0,3,3,1.0,1.0
Plestiodon gilberti,19,59,78,0.022432893150316244,0.020337142006381065
Plestiodon skiltonianus,3,12,15,0.46864155961299403,0.8094879786929297
Pleuricospora fimbriolata,1,88,89,2.7274100974924606e-05,0.0006030291587125807
Pleurota albastrigulella,0,2,2,1.0,1.0
Pleurotus dryinus,1,1,2,0.2685730424867646,0.6723203844978234
Pleurotus ostreatus,9,8,17,0.00022350676454465927,3.1437133229831e-05
Pleurotus populinus,0,1,1,1.0,1.0
Pleurotus pulmonarius,1,5,6,1.0,1.0
Plicaria endocarpoides,1,10,11,1.0,0.9368824658167821
Plutella xylostella,0,3,3,1.0,1.0
Pluteus atromarginatus,2,4,6,0.21128172197002185,0.4637992200137968
Pluteus brunneidiscus,0,2,2,1.0,1.0
Pluteus cervinus,0,4,4,1.0,0.9105509465652237
Pluteus exilis,3,6,9,0.12984024511270734,0.25675213762300036
Pluteus orestes,0,5,5,1.0,0.7760428250025136
Pluteus petasatus,1,1,2,0.2685730424867646,0.6723203844978234
Pluteus pouzarianus,0,1,1,1.0,1.0
Pluteus primus,0,2,2,1.0,1.0
Pluteus romellii,0,1,1,1.0,1.0
Pluteus vellingae,0,1,1,1.0,1.0
Plutomurus wilkeyi,0,1,1,1.0,1.0
Pluvialis squatarola,0,1,1,1.0,1.0
Poa annua,2,2,4,0.10278607328810296,0.1906437976216683
Poa bolanderi,0,3,3,1.0,1.0
Poa bulbosa,17,38,55,0.0016529110596693935,0.0010666096986580575
Poa pratensis,0,2,2,1.0,1.0
Poa secunda,2,6,8,0.3262180684327187,0.7311980927864552
Poa sierrae,1,2,3,0.3744588472376553,0.9141432822130974
Poa wheeleri,0,1,1,1.0,1.0
Podabrus pruinosus,6,18,24,0.14619697113894947,0.23991552587399764
Podabrus youngi,2,5,7,0.2688137426846044,0.6011437582684053
Podiceps auritus,0,1,1,1.0,1.0
Podiceps nigricollis,1,10,11,1.0,0.9368824658167821
Podilymbus podiceps,0,8,8,0.6124215574698968,0.5084255632839996
Podistera nevadensis,0,23,23,0.06652127337221461,0.09355974164186621
Podosphaera aphanis,1,0,1,0.14476460320460613,0.3126936942061339
Podosphaera leucotricha,1,0,1,0.14476460320460613,0.3126936942061339
Podosphaera mors-uvae,0,2,2,1.0,1.0
Podosphaera pannosa,1,0,1,0.14476460320460613,0.3126936942061339
Poecile gambeli,27,642,669,1.4561417766464286e-18,2.2982745091082024e-14
Poecile rufescens,11,9,20,2.7425906097786204e-05,1.3450060134341505e-06
Pohlia nutans,0,1,1,1.0,1.0
Polemonium californicum,0,250,250,1.7369958917695836e-17,1.3685333774264927e-10
Polemonium chartaceum,1,4,5,0.5424646889787644,1.0
Polemonium eximium,1,8,9,1.0,1.0
Polemonium micranthum,0,3,3,1.0,1.0
Polemonium occidentale,2,210,212,5.52914622589581e-12,3.683638099252068e-08
Polemonium pulcherrimum,0,8,8,0.6124215574698968,0.5084255632839996
Polia nugatis,0,2,2,1.0,1.0
Polia piniae,0,4,4,1.0,0.9105509465652237
Polioptila caerulea,2,14,16,1.0,1.0
Polistes aurifer,6,13,19,0.04622915715125239,0.07301310260852441
Polistes dominula,6,21,27,0.268604493738199,0.3840576019500902
Polites mystic,1,111,112,1.0969488817828819e-06,7.737375806251453e-05
Polites sabuleti,0,62,62,9.301071970661966e-05,0.0022166361182995335
Polycaon stoutii,0,11,11,0.38449278358904854,0.3492157200022511
Polycarpon tetraphyllum,0,1,1,1.0,1.0
Polycauliona polycarpa,3,1,4,0.010816792675262966,0.00633924523846032
Polydrusus impressifrons,0,1,1,1.0,1.0
Polyergus mexicanus,2,20,22,0.7605811964984595,0.6781643221724958
Polygonia faunus,1,8,9,1.0,1.0
Polygonia gracilis,2,156,158,1.1295874664501953e-08,4.063637151076314e-06
Polygonia satyrus,3,3,6,0.0431068667335647,0.05837521372070738
Polygonum arenastrum,0,2,2,1.0,1.0
Polygonum aviculare,0,4,4,1.0,0.9105509465652237
Polygonum bidwelliae,1,1,2,0.2685730424867646,0.6723203844978234
Polygonum douglasii,0,14,14,0.24486350799097997,0.24618548812479032
Polygonum kelloggii,0,3,3,1.0,1.0
Polygonum minimum,0,5,5,1.0,0.7760428250025136
Polygonum polygaloides,1,4,5,0.5424646889787644,1.0
Polygonum sawatchense,0,2,2,1.0,1.0
Polygonum shastense,0,14,14,0.24486350799097997,0.24618548812479032
Polygonum spergulariiforme,0,6,6,0.6025804396089913,0.6688993551184468
Polyphylla crinita,1,0,1,0.14476460320460613,0.3126936942061339
Polyphylla decemlineata,10,38,48,0.21660487327837888,0.2952410318192489
Polyphylla sobrina,0,10,10,0.3757244358299004,0.39438447212016514
Polypodium californicum,4,0,4,0.00043910829886184923,3.314336839661014e-05
Polypodium calirhiza,7,0,7,1.3315701680073362e-06,3.775277184632102e-09
Polypodium glycyrrhiza,1,0,1,0.14476460320460613,0.3126936942061339
Polypogon interruptus,0,1,1,1.0,1.0
Polypogon monspeliensis,2,0,2,0.0209561639230412,0.01499159650771353
Polyschismium chailletii,0,1,1,1.0,1.0
Polyschismium fallax,0,1,1,1.0,1.0
Polystichum californicum,3,2,5,0.02413002787627292,0.023975245305455268
Polystichum imbricans,9,50,59,0.8529093884462987,1.0
Polystichum lemmonii,0,1,1,1.0,1.0
Polystichum lonchitis,0,1,1,1.0,1.0
Polystichum munitum,13,14,27,3.2941979093487867e-05,2.610230905713789e-06
Polystichum scopulinum,1,1,2,0.2685730424867646,0.6723203844978234
Polystoechotes punctata,2,26,28,0.41855855454898133,0.4040672905640138
Polytrichum juniperinum,1,8,9,1.0,1.0
Polytrichum piliferum,1,0,1,0.14476460320460613,0.3126936942061339
Pomoxis nigromaculatus,1,1,2,0.2685730424867646,0.6723203844978234
Pontia beckerii,0,8,8,0.6124215574698968,0.5084255632839996
Pontia occidentalis,0,9,9,0.37460992252836506,0.4468858706621094
Pontia protodice,7,32,39,0.4963356603436203,0.6974506535176623
Pontia sisymbrii,2,4,6,0.21128172197002185,0.4637992200137968
Pooecetes gramineus,1,8,9,1.0,1.0
Populus alba,0,2,2,1.0,1.0
Populus fremontii,5,2,7,0.0010327341762908842,0.00018014051424031924
Populus tremuloides,6,577,583,5.960882309354343e-31,4.214269117261335e-20
Populus trichocarpa,5,91,96,0.00816463869592484,0.01483606425951579
Porcellio dilatatus,1,0,1,0.14476460320460613,0.3126936942061339
Porcellio scaber,3,4,7,0.0674516701814297,0.11027569540283454
Poriella subacida,0,1,1,1.0,1.0
Porodaedalea pini,13,6,19,1.3992236861626746e-07,2.0575240449829025e-10
Porpidia crustulata,0,1,1,1.0,1.0
Porterella carnosula,0,16,16,0.15161267346782015,0.19687992504129675
Portulaca oleracea,2,3,5,0.15522343689242213,0.32387652224382535
Porzana carolina,1,2,3,0.3744588472376553,0.9141432822130974
Potamogeton amplifolius,0,1,1,1.0,1.0
Potamogeton crispus,0,1,1,1.0,1.0
Potamogeton gramineus,0,1,1,1.0,1.0
Potamogeton natans,0,7,7,0.6034645370398923,0.5813304975648097
Potamogeton praelongus,0,4,4,1.0,0.9105509465652237
Potentilla aperta,1,7,8,1.0,1.0
Potentilla biennis,2,2,4,0.10278607328810296,0.1906437976216683
Potentilla breweri,0,33,33,0.010891466813681657,0.034323099218764155
Potentilla bruceae,0,3,3,1.0,1.0
Potentilla campestris,1,7,8,1.0,1.0
Potentilla douglasii,0,118,118,1.918278815292918e-08,1.4269228073378592e-05
Potentilla drummondii,0,1,1,1.0,1.0
Potentilla flabellifolia,0,17,17,0.15747128520432685,0.17645428752866515
Potentilla glaucophylla,1,0,1,0.14476460320460613,0.3126936942061339
Potentilla gordonii,0,6,6,0.6025804396089913,0.6688993551184468
Potentilla gracilis,2,140,142,1.252054341490319e-07,1.6475571303061605e-05
Potentilla indica,1,3,4,0.4650164385481151,1.0
Potentilla kingii,1,5,6,1.0,1.0
Potentilla lycopodioides,0,13,13,0.23752623411074927,0.27601031745794824
Potentilla millefolia,0,1,1,1.0,1.0
Potentilla morefieldii,3,5,8,0.09660076546782431,0.17754400284199642
Potentilla muirii,0,1,1,1.0,1.0
Potentilla newberryi,0,2,2,1.0,1.0
Potentilla norvegica,0,2,2,1.0,1.0
Potentilla purpurascens,0,4,4,1.0,0.9105509465652237
Potentilla recta,0,5,5,1.0,0.7760428250025136
Potentilla santolinoides,7,91,98,0.042882187595146115,0.05483207389997504
Potentilla saxosa,1,6,7,1.0,1.0
Potentilla sericoleuca,0,12,12,0.2360424886052977,0.31009055076592434
Potentilla shockleyi,0,2,2,1.0,1.0
Potentilla tilingii,6,33,39,0.8203203409991585,1.0
Potentilla tularensis,0,1,1,1.0,1.0
Potentilla webberi,0,5,5,1.0,0.7760428250025136
Potentilla wheeleri,0,2,2,1.0,1.0
Poteridium occidentale,0,8,8,0.6124215574698968,0.5084255632839996
Poterium sanguisorba,17,7,24,6.64841942921259e-10,4.126546092558054e-14
Prenolepis imparis,16,10,26,4.573333604856251e-08,6.081241109342548e-11
Priacma serrata,0,19,19,0.09746384240092232,0.14226189947649115
Primula suffrutescens,2,73,75,0.001462322120470972,0.006085692473085201
Prionus californicus,22,38,60,1.7445423322196e-05,2.5731727158603915e-06
Pristaulacus foxleei,0,1,1,1.0,1.0
Pritchardomyia vespoides,2,2,4,0.10278607328810296,0.1906437976216683
Proboscidea louisianica,0,2,2,1.0,1.0
Procambarus clarkii,1,1,2,0.2685730424867646,0.6723203844978234
Procecidochares minuta,0,1,1,1.0,1.0
Procyon lotor,5,30,35,1.0,1.0
Prodiplosis morrisi,0,1,1,1.0,1.0
Progomphus borealis,1,0,1,0.14476460320460613,0.3126936942061339
Prolita incicur,0,1,1,1.0,1.0
Prolita jubata,0,1,1,1.0,1.0
Pronocera collaris,0,2,2,1.0,1.0
Prophysaon andersonii,6,1,7,5.640935459925577e-05,1.4388133744720056e-06
Prosartes hookeri,14,105,119,0.5136987273591554,0.47729029155125835
Proserpinus clarkiae,1,15,16,0.4958553183213633,0.5619415773454699
Proserpinus lucidus,0,1,1,1.0,1.0
Prosopium williamsoni,0,1,1,1.0,1.0
Protitame subalbaria,0,8,8,0.6124215574698968,0.5084255632839996
Protochauliodes aridus,1,0,1,0.14476460320460613,0.3126936942061339
Protochauliodes montivagus,1,0,1,0.14476460320460613,0.3126936942061339
Protogygia milleri,0,25,25,0.04095412181173697,0.07622457957144455
Protoparmeliopsis muralis,1,2,3,0.3744588472376553,0.9141432822130974
Protoparmeliopsis peltata,0,1,1,1.0,1.0
Protoparmeliopsis sierrae,0,1,1,1.0,1.0
Protosmia rubifloris,1,1,2,0.2685730424867646,0.6723203844978234
Prototrichia metallica,0,3,3,1.0,1.0
Prunella vulgaris,79,277,356,0.00010857656948140563,4.800736408262709e-05
Prunus amygdalus,2,0,2,0.0209561639230412,0.01499159650771353
Prunus andersonii,8,25,33,0.1321293730219027,0.1779319665656241
Prunus avium,1,0,1,0.14476460320460613,0.3126936942061339
Prunus cerasifera,0,3,3,1.0,1.0
Prunus emarginata,3,198,201,2.81694177051188e-10,2.83760038115708e-07
Prunus laurocerasus,1,0,1,0.14476460320460613,0.3126936942061339
Prunus persica,0,1,1,1.0,1.0
Prunus subcordata,1,3,4,0.4650164385481151,1.0
Prunus virginiana,2,39,41,0.11530043436325724,0.12727654269489433
Psaltriparus minimus,22,19,41,4.9543116669992284e-09,4.879014991290732e-12
Psathyrella bipellis,0,1,1,1.0,1.0
Psathyrella ellenae,0,2,2,1.0,1.0
Psathyrella longipes,12,2,14,5.776306606320184e-09,6.210056186652793e-13
Psathyrella longistriata,1,1,2,0.2685730424867646,0.6723203844978234
Psathyrella pennata,0,9,9,0.37460992252836506,0.4468858706621094
Psathyrella piluliformis,1,1,2,0.2685730424867646,0.6723203844978234
Psathyrella seymourensis,0,3,3,1.0,1.0
Psathyrella umbrosa,0,1,1,1.0,1.0
Psathyrotes annua,0,2,2,1.0,1.0
Pselliopus spinicollis,2,1,3,0.056801432979852025,0.0803492820202322
Pseudacris regilla,228,889,1117,6.964337527362614e-08,2.0112918044846103e-08
Pseudanostirus tigrinus,0,4,4,1.0,0.9105509465652237
Pseudastylopsis nebulosus,0,6,6,0.6025804396089913,0.6688993551184468
Pseudephebe minuscula,0,1,1,1.0,1.0
Pseudeva palligera,0,7,7,0.6034645370398923,0.5813304975648097
Pseudobahia heermannii,1,0,1,0.14476460320460613,0.3126936942061339
Pseudobraunia californica,1,0,1,0.14476460320460613,0.3126936942061339
Pseudochalcura gibbosa,0,2,2,1.0,1.0
Pseudochelaria manzanitae,0,3,3,1.0,1.0
Pseudochorthippus curtipennis,0,2,2,1.0,1.0
Pseudocistela opaca,0,2,2,1.0,1.0
Pseudocistela pinguis,1,0,1,0.14476460320460613,0.3126936942061339
Pseudoclitocybe cyathiformis,7,0,7,1.3315701680073362e-06,3.775277184632102e-09
Pseudocopaeodes eunus,0,1,1,1.0,1.0
Pseudogaurotina cressoni,0,1,1,1.0,1.0
Pseudognaphalium beneolens,1,3,4,0.4650164385481151,1.0
Pseudognaphalium californicum,4,2,6,0.005153189017352294,0.0022646484484871816
Pseudognaphalium canescens,0,4,4,1.0,0.9105509465652237
Pseudognaphalium macounii,0,1,1,1.0,1.0
Pseudognaphalium thermale,0,2,2,1.0,1.0
Pseudohydnum gelatinosum,22,34,56,4.750434983473226e-06,3.634230983069514e-07
Pseudoinonotus dryadeus,0,1,1,1.0,1.0
Pseudomarasmius pallidocephalus,0,1,1,1.0,1.0
Pseudomasaris coquilletti,1,2,3,0.3744588472376553,0.9141432822130974
Pseudomasaris edwardsi,0,9,9,0.37460992252836506,0.4468858706621094
Pseudomasaris vespoides,2,19,21,0.758229331207162,0.7376635310426026
Pseudomasaris wheeleri,1,0,1,0.14476460320460613,0.3126936942061339
Pseudoomphalina angelesiana,1,6,7,1.0,1.0
Pseudopithyella minuscula,1,0,1,0.14476460320460613,0.3126936942061339
Pseudoscaeva diversifasciata,0,4,4,1.0,0.9105509465652237
Pseudosciaphila duplex,0,4,4,1.0,0.9105509465652237
Pseudotsuga menziesii,115,195,310,6.164618470578295e-23,2.3947327695158393e-29
Pseudoxylosteus ornatus,0,1,1,1.0,1.0
Psilocarphus brevissimus,0,3,3,1.0,1.0
Psilocarphus tenellus,2,4,6,0.21128172197002185,0.4637992200137968
Psilocybe cyanescens,1,0,1,0.14476460320460613,0.3126936942061339
Psilocybe ovoideocystidiata,1,0,1,0.14476460320460613,0.3126936942061339
Psiloscops flammeolus,1,6,7,1.0,1.0
Psora cerebriformis,0,1,1,1.0,1.0
Psora nipponica,0,1,1,1.0,1.0
Psorothamnus arborescens,0,2,2,1.0,1.0
Psorothamnus polydenius,0,2,2,1.0,1.0
Psychoglypha bella,0,2,2,1.0,1.0
Psylla floccosa,0,3,3,1.0,1.0
Psylla sanguinea,0,1,1,1.0,1.0
Psyllobora borealis,1,3,4,0.4650164385481151,1.0
Psyllobora renifer,2,0,2,0.0209561639230412,0.01499159650771353
Psyllobora vigintimaculata,0,1,1,1.0,1.0
Pteridium aquilinum,130,927,1057,0.04374539594643953,0.04843315096127104
Pterigynandrum filiforme,0,2,2,1.0,1.0
Pteronarcys californica,1,0,1,0.14476460320460613,0.3126936942061339
Pterospora andromedea,80,1567,1647,1.618451640634168e-36,1.1743750076443308e-28
Pterostegia drymarioides,1,0,1,0.14476460320460613,0.3126936942061339
Pterostichus adstrictus,0,1,1,1.0,1.0
Pterostichus amethystinus,0,1,1,1.0,1.0
Pterostichus lama,1,38,39,0.036658892545794367,0.059174927856222845
Pterostichus ordinarius,0,1,1,1.0,1.0
Pterotus obscuripennis,2,2,4,0.10278607328810296,0.1906437976216683
Pteryxia petraea,1,1,2,0.2685730424867646,0.6723203844978234
Pteryxia terebinthina,0,38,38,0.004498886955203611,0.021117085915288634
Ptychocheilus grandis,3,1,4,0.010816792675262966,0.00633924523846032
Ptychomitrium gardneri,2,0,2,0.0209561639230412,0.01499159650771353
Puccinia caricina,0,1,1,1.0,1.0
Puccinia lagenophorae,1,1,2,0.2685730424867646,0.6723203844978234
Puccinia monardellae,0,1,1,1.0,1.0
Puccinia monoica,1,60,61,0.0015299896401216825,0.00763263044687312
Puccinia striiformis,0,1,1,1.0,1.0
Pulsatilla occidentalis,0,21,21,0.06152025756350138,0.11517086832716916
Pulvinula archeri,0,3,3,1.0,1.0
Puma concolor,18,38,56,0.0008019626884334777,0.0003599263294419533
Punctularia atropurpurascens,1,1,2,0.2685730424867646,0.6723203844978234
Purpuricenus dimidiatus,1,0,1,0.14476460320460613,0.3126936942061339
Purshia glandulosa,1,8,9,1.0,1.0
Purshia stansburiana,1,8,9,1.0,1.0
Purshia tridentata,14,393,407,2.3152302809422745e-13,3.7538835102940474e-10
Purshivora chelifera,1,0,1,0.14476460320460613,0.3126936942061339
Purshivora pubescens,0,2,2,1.0,1.0
Puto arctostaphyli,1,0,1,0.14476460320460613,0.3126936942061339
Pycnanthemum californicum,3,5,8,0.09660076546782431,0.17754400284199642
Pycnoporellus alboluteus,0,34,34,0.011544912843706439,0.03112496262794068
Pycnoporellus fulgens,0,7,7,0.6034645370398923,0.5813304975648097
Pygoleptura brevicornis,0,2,2,1.0,1.0
Pyracantha coccinea,1,0,1,0.14476460320460613,0.3126936942061339
Pyrausta californicalis,1,2,3,0.3744588472376553,0.9141432822130974
Pyrausta fodinalis,0,2,2,1.0,1.0
Pyrausta grotei,0,13,13,0.23752623411074927,0.27601031745794824
Pyrausta laticlavia,1,0,1,0.14476460320460613,0.3126936942061339
Pyrausta lethalis,1,1,2,0.2685730424867646,0.6723203844978234
Pyrausta nexalis,0,12,12,0.2360424886052977,0.31009055076592434
Pyrausta nicalis,0,2,2,1.0,1.0
Pyrausta perrubralis,0,2,2,1.0,1.0
Pyrausta semirubralis,0,48,48,0.0007986906096022093,0.008153714424496968
Pyrausta subsequalis,2,1,3,0.056801432979852025,0.0803492820202322
Pyrausta unifascialis,0,6,6,0.6025804396089913,0.6688993551184468
Pyrausta volupialis,2,1,3,0.056801432979852025,0.0803492820202322
Pyrgus ruralis,1,37,38,0.03563497956271764,0.06506592507691755
Pyrocephalus rubinus,0,4,4,1.0,0.9105509465652237
Pyrola aphylla,9,109,118,0.035279194153417424,0.04722042920184677
Pyrola asarifolia,1,124,125,1.352878818825774e-07,2.444265031046302e-05
Pyrola dentata,3,163,166,4.8964579882075015e-08,5.87956015950974e-06
Pyrola minor,0,14,14,0.24486350799097997,0.24618548812479032
Pyrola picta,5,647,652,1.0562029856504983e-36,3.7820196875970793e-23
Pyronema domesticum,0,1,1,1.0,1.0
Pyronema omphalodes,1,16,17,0.4959452943950571,0.5076929481255973
Pyropyga nigricans,1,1,2,0.2685730424867646,0.6723203844978234
Pyrrharctia isabella,27,48,75,3.052655392262981e-06,2.8307188510102563e-07
Pyrrhia exprimens,0,4,4,1.0,0.9105509465652237
Pyrrocoma apargioides,1,25,26,0.16397356670156135,0.20698867318680708
Pyrrocoma lucida,0,3,3,1.0,1.0
Pyrus calleryana,0,1,1,1.0,1.0
Quercus berberidifolia,3,0,3,0.0030335293929702875,0.000700171082788584
Quercus chrysolepis,232,252,484,1.2383595892947397e-68,8.13890781290816e-97
Quercus douglasii,16,0,16,3.7071491350627856e-14,7.428055522255346e-21
Quercus durata,22,0,22,3.4007357672113824e-19,1.2809012267363651e-28
Quercus eplingii,2,0,2,0.0209561639230412,0.01499159650771353
Quercus ganderi,1,0,1,0.14476460320460613,0.3126936942061339
Quercus garryana,40,4,44,1.9274760501598606e-29,9.662659674714923e-46
Quercus kelloggii,352,837,1189,9.076151517506449e-41,9.537761810620215e-50
Quercus lobata,16,1,17,5.44390186269873e-13,2.517003025282252e-19
Quercus morehus,15,0,15,2.561960637721327e-13,1.46850157852256e-19
Quercus vacciniifolia,1,364,365,1.7470955517530418e-23,2.1033553464319153e-14
Quercus wislizeni,40,2,42,1.6568952348454338e-31,1.2108100094982317e-48
Quiscalus mexicanus,2,1,3,0.056801432979852025,0.0803492820202322
Rabdophaga salicisbrassicoides,1,1,2,0.2685730424867646,0.6723203844978234
Raillardella argentea,0,39,39,0.0046877939621657125,0.019179555698833974
Raillardella scaposa,0,21,21,0.06152025756350138,0.11517086832716916
Rallus limicola,0,4,4,1.0,0.9105509465652237
Ramalina farinacea,0,1,1,1.0,1.0
Ramaria amyloidea,0,1,1,1.0,1.0
Ramaria apiculata,1,0,1,0.14476460320460613,0.3126936942061339
Ramaria largentii,0,2,2,1.0,1.0
Ramaria pinicola,0,3,3,1.0,1.0
Ramaria purpurissima,0,1,1,1.0,1.0
Ramaria rasilispora,2,23,25,0.5680820909074459,0.5246799429989071
Ramaria rubiginosa,0,4,4,1.0,0.9105509465652237
Ramaria rubricarnata,0,3,3,1.0,1.0
Ramaria spinulosa,1,0,1,0.14476460320460613,0.3126936942061339
Ramaria subviolacea,0,2,2,1.0,1.0
Ramaria violaceibrunnea,2,0,2,0.0209561639230412,0.01499159650771353
Ramariopsis kunzei,0,1,1,1.0,1.0
Rana boylii,59,94,153,2.1857620657379337e-13,6.523553890882518e-17
Rana draytonii,2,8,10,0.6456440117183423,0.9624710515030661
Rana muscosa,5,4,9,0.004804892843884087,0.0024551155675152643
Rana sierrae,3,128,131,4.702729200828467e-06,0.00012246166689207542
Ranunculus alismifolius,0,86,86,3.3333992826341014e-06,0.0002493329886354844
Ranunculus aquatilis,2,22,24,0.5653148798484595,0.5718848303294736
Ranunculus eschscholtzii,0,2,2,1.0,1.0
Ranunculus flammula,0,1,1,1.0,1.0
Ranunculus glaberrimus,0,10,10,0.3757244358299004,0.39438447212016514
Ranunculus muricatus,7,3,10,0.00010655132026942219,5.604574097560587e-06
Ranunculus occidentalis,26,48,74,7.70406306148075e-06,1.0272692622396366e-06
Ranunculus repens,1,2,3,0.3744588472376553,0.9141432822130974
Ranunculus trichophyllus,0,1,1,1.0,1.0
Ranunculus uncinatus,0,18,18,0.0958116006335464,0.1583481410858158
Raphanus raphanistrum,1,0,1,0.14476460320460613,0.3126936942061339
Raphia frater,0,7,7,0.6034645370398923,0.5813304975648097
Recurvirostra americana,0,3,3,1.0,1.0
Regulus calendula,14,62,76,0.3271706811194244,0.4153747446985824
Regulus satrapa,7,74,81,0.15566370007925823,0.18196307448395385
Resupinatus alboniger,0,2,2,1.0,1.0
Reticularia lycoperdon,3,31,34,0.4680650951624178,0.48822025325718277
Retinia picicolana,0,1,1,1.0,1.0
Retinia sabiniana,0,3,3,1.0,1.0
Rhagio tringaria,1,1,2,0.2685730424867646,0.6723203844978234
Rhagium inquisitor,1,7,8,1.0,1.0
Rhantus binotatus,0,1,1,1.0,1.0
Rhinichthys klamathensis,0,2,2,1.0,1.0
Rhinichthys osculus,0,7,7,0.6034645370398923,0.5813304975648097
Rhinocheilus lecontei,0,1,1,1.0,1.0
Rhinocyllus conicus,1,0,1,0.14476460320460613,0.3126936942061339
Rhinotropis cornuta,32,44,76,4.8876395567276756e-09,2.3310823548740094e-11
Rhinusa tetra,1,1,2,0.2685730424867646,0.6723203844978234
Rhionaeschna californica,2,5,7,0.2688137426846044,0.6011437582684053
Rhionaeschna multicolor,3,28,31,0.6120501383333876,0.6141187291654486
Rhizocarpon geographicum,1,7,8,1.0,1.0
Rhizocarpon lecanorinum,0,3,3,1.0,1.0
Rhizomnium magnifolium,0,1,1,1.0,1.0
Rhizoplaca glaucophana,0,1,1,1.0,1.0
Rhizoplaca melanophthalma,1,16,17,0.4959452943950571,0.5076929481255973
Rhizopogon arctostaphyli,0,1,1,1.0,1.0
Rhizopogon evadens,0,2,2,1.0,1.0
Rhizopogon fuscorubens,0,1,1,1.0,1.0
Rhizopogon hawkerae,2,0,2,0.0209561639230412,0.01499159650771353
Rhizopogon occidentalis,3,2,5,0.02413002787627292,0.023975245305455268
Rhizopogon ochraceorubens,1,0,1,0.14476460320460613,0.3126936942061339
Rhizopogon olivaceotinctus,0,1,1,1.0,1.0
Rhodiola integrifolia,3,130,133,3.184069411910356e-06,0.00010294317668873692
Rhodocollybia butyracea,3,3,6,0.0431068667335647,0.05837521372070738
Rhodocollybia maculata,0,2,2,1.0,1.0
Rhododendron columbianum,6,350,356,8.841528669030735e-17,1.1232316989925809e-11
Rhododendron occidentale,52,529,581,7.228068971367837e-05,0.00018973369787049298
Rhodofomes cajanderi,5,5,10,0.008469540260789258,0.0060826780961133285
Rhodophana nitellina,1,4,5,0.5424646889787644,1.0
Rhopalomyia anthoides,2,0,2,0.0209561639230412,0.01499159650771353
Rhopalomyia californica,0,2,2,1.0,1.0
Rhopalomyia chrysothamni,0,1,1,1.0,1.0
Rhopalomyia lignea,0,3,3,1.0,1.0
Rhopalomyia medusirrasa,2,4,6,0.21128172197002185,0.4637992200137968
Rhopalomyia nucula,2,0,2,0.0209561639230412,0.01499159650771353
Rhopalomyia obovata,1,0,1,0.14476460320460613,0.3126936942061339
Rhopalomyia pomum,2,21,23,0.5652342527632244,0.6229726880589948
Rhopalomyia tubulus,2,0,2,0.0209561639230412,0.01499159650771353
Rhopalomyia tumidibulla,2,0,2,0.0209561639230412,0.01499159650771353
Rhus aromatica,1,1,2,0.2685730424867646,0.6723203844978234
Rhus glabra,3,0,3,0.0030335293929702875,0.000700171082788584
Rhynchospora alba,0,1,1,1.0,1.0
Rhynocoris ventralis,0,10,10,0.3757244358299004,0.39438447212016514
Rhyssa persuasoria,0,1,1,1.0,1.0
Rhyssella nitida,0,1,1,1.0,1.0
Rhytisma punctatum,1,10,11,1.0,0.9368824658167821
Ribes aureum,1,10,11,1.0,0.9368824658167821
Ribes cereum,12,411,423,1.2780376976546773e-15,1.5660460555556534e-11
Ribes inerme,0,66,66,6.224445011594697e-05,0.001534757489456566
Ribes lasianthum,0,15,15,0.14994170356869613,0.21998124924271661
Ribes malvaceum,0,1,1,1.0,1.0
Ribes montigenum,8,190,198,3.717518809512602e-06,4.611278451436857e-05
Ribes nevadense,33,443,476,4.281501888710704e-07,3.87595905782957e-06
Ribes quercetorum,1,0,1,0.14476460320460613,0.3126936942061339
Ribes roezlii,105,808,913,0.0094813660159146,0.01192625359055406
Ribes velutinum,1,24,25,0.2476906644158463,0.22836298286850215
Ribes viscosissimum,0,134,134,1.4729618818977061e-09,3.460888520842599e-06
Riccia cavernosa,1,1,2,0.2685730424867646,0.6723203844978234
Riccia glauca,0,1,1,1.0,1.0
Richardsonius egregius,0,14,14,0.24486350799097997,0.24618548812479032
Ricinus communis,0,1,1,1.0,1.0
Rickenella fibula,0,19,19,0.09746384240092232,0.14226189947649115
Rickenella mellea,0,1,1,1.0,1.0
Rimbachia bryophila,4,2,6,0.005153189017352294,0.0022646484484871816
Rinodina milvina,0,1,1,1.0,1.0
Robinia pseudoacacia,5,6,11,0.013693210356916412,0.012717642011991449
Rogerpetersonia torreyae,1,1,2,0.2685730424867646,0.6723203844978234
Rorippa curvisiliqua,0,4,4,1.0,0.9105509465652237
Rorippa subumbellata,0,14,14,0.24486350799097997,0.24618548812479032
Rosa bridgesii,0,11,11,0.38449278358904854,0.3492157200022511
Rosa californica,9,10,19,0.0006451642095409557,0.00017764735335142312
Rosa gymnocarpa,3,20,23,1.0,1.0
Rosa rugosa,0,2,2,1.0,1.0
Rosa woodsii,5,138,143,2.4713445074301313e-05,0.00030142389093477847
Rosalia funebris,0,7,7,0.6034645370398923,0.5813304975648097
Rosulabryum capillare,0,2,2,1.0,1.0
Rubroboletus eastwoodiae,1,0,1,0.14476460320460613,0.3126936942061339
Rubroboletus haematinus,0,5,5,1.0,0.7760428250025136
Rubus armeniacus,76,28,104,3.604971848075823e-41,1.0627611308354677e-63
Rubus bifrons,7,2,9,3.65759227530616e-05,8.499366410736652e-07
Rubus glaucifolius,0,2,2,1.0,1.0
Rubus laciniatus,48,76,124,3.030296436008829e-11,4.560567759406269e-14
Rubus leucodermis,11,71,82,0.8763139575251738,0.9073619144146368
Rubus parviflorus,78,941,1019,2.973152293702157e-11,7.258269273977456e-10
Rubus ursinus,11,8,19,1.420942410948486e-05,4.3511225483923443e-07
Rudbeckia californica,2,143,145,8.459108075136758e-08,1.2668869704714924e-05
Rudbeckia hirta,0,2,2,1.0,1.0
Rudbeckia occidentalis,0,8,8,0.6124215574698968,0.5084255632839996
Rufoplaca arenaria,1,0,1,0.14476460320460613,0.3126936942061339
Rumex acetosella,9,34,43,0.2737217507327221,0.3240587116912362
Rumex californicus,0,1,1,1.0,1.0
Rumex crispus,2,6,8,0.3262180684327187,0.7311980927864552
Rumex obtusifolius,0,1,1,1.0,1.0
Rumex paucifolius,0,9,9,0.37460992252836506,0.4468858706621094
Rumex salicifolius,1,4,5,0.5424646889787644,1.0
Rusavskia sorediata,0,1,1,1.0,1.0
Russula adusta,1,0,1,0.14476460320460613,0.3126936942061339
Russula albonigra,0,4,4,1.0,0.9105509465652237
Russula brevipes,12,36,48,0.06049724625171873,0.061872084222475275
Russula cascadensis,0,1,1,1.0,1.0
Russula cerolens,3,1,4,0.010816792675262966,0.00633924523846032
Russula cremoricolor,4,2,6,0.005153189017352294,0.0022646484484871816
Russula densifolia,1,1,2,0.2685730424867646,0.6723203844978234
Russula exalbicans,0,1,1,1.0,1.0
Russula fragrantissima,2,1,3,0.056801432979852025,0.0803492820202322
Russula mendocinensis,1,0,1,0.14476460320460613,0.3126936942061339
Russula montana,0,1,1,1.0,1.0
Russula monticola,0,1,1,1.0,1.0
Russula mustelina,0,2,2,1.0,1.0
Russula rhodocephala,3,1,4,0.010816792675262966,0.00633924523846032
Russula salishensis,1,0,1,0.14476460320460613,0.3126936942061339
Russula sanguinea,0,1,1,1.0,1.0
Russula sierrensis,0,1,1,1.0,1.0
Russula subloculata,0,1,1,1.0,1.0
Russula xerampelina,2,16,18,1.0,0.9435167712853587
Sabulina douglasii,0,8,8,0.6124215574698968,0.5084255632839996
Sabulina nuttallii,1,20,21,0.3485544901265487,0.3394968187912247
Sabulodes aegrotata,1,0,1,0.14476460320460613,0.3126936942061339
Sabulodes edwardsata,4,44,48,0.3044007402301794,0.3150887453678105
Sagina procumbens,0,1,1,1.0,1.0
Sagina saginoides,0,9,9,0.37460992252836506,0.4468858706621094
Sagittaria cuneata,0,3,3,1.0,1.0
Sairocarpus cornutus,1,0,1,0.14476460320460613,0.3126936942061339
Sairocarpus multiflorus,1,0,1,0.14476460320460613,0.3126936942061339
Sairocarpus vexillocalyculatus,1,1,2,0.2685730424867646,0.6723203844978234
Salebriacus odiosella,0,2,2,1.0,1.0
Salix drummondiana,0,1,1,1.0,1.0
Salix eastwoodiae,0,16,16,0.15161267346782015,0.19687992504129675
Salix exigua,4,12,16,0.2740043737810785,0.40028983280731434
Salix geyeriana,0,12,12,0.2360424886052977,0.31009055076592434
Salix gooddingii,2,0,2,0.0209561639230412,0.01499159650771353
Salix lasiolepis,4,6,10,0.044556650138771095,0.06510377152388026
Salix lemmonii,0,21,21,0.06152025756350138,0.11517086832716916
Salix lucida,1,20,21,0.3485544901265487,0.3394968187912247
Salix lutea,0,3,3,1.0,1.0
Salix nivalis,0,2,2,1.0,1.0
Salix orestera,0,3,3,1.0,1.0
Salix petrophila,0,18,18,0.0958116006335464,0.1583481410858158
Salix planifolia,0,1,1,1.0,1.0
Salix prolixa,0,1,1,1.0,1.0
Salix scouleriana,1,43,44,0.01643618076915838,0.036921759051915914
Salmo trutta,10,39,49,0.22515445489922212,0.3284808405617284
Salpinctes obsoletus,4,44,48,0.3044007402301794,0.3150887453678105
Salvelinus fontinalis,6,215,221,7.763161313304886e-09,1.08076202462546e-06
Salvia columbariae,7,6,13,0.0010192335799894875,0.0002724004392891465
Salvia dorrii,13,41,54,0.05258649018504958,0.07009736887884682
Salvia pachyphylla,13,8,21,7.876614523055535e-07,4.433227163928297e-09
Salvia sclarea,1,0,1,0.14476460320460613,0.3126936942061339
Salvia sonomensis,33,22,55,9.257286083216466e-15,5.2196689182894286e-21
Sambucus cerulea,42,373,415,0.009734584644155752,0.01409748249976023
Sambucus racemosa,0,222,222,1.1939241404447873e-15,1.5595678961320743e-09
Sanguisorba officinalis,0,1,1,1.0,1.0
Sanicula bipinnata,1,1,2,0.2685730424867646,0.6723203844978234
Sanicula bipinnatifida,15,2,17,2.6033123128730738e-11,1.052465630476958e-16
Sanicula crassicaulis,30,6,36,5.140745082106986e-20,1.2342769619176287e-30
Sanicula graveolens,0,26,26,0.025555133894118995,0.0688671495635685
Sanicula tuberosa,4,30,34,0.8102076920842114,0.8370258356798727
Saperda calcarata,0,1,1,1.0,1.0
Saperda populnea,1,0,1,0.14476460320460613,0.3126936942061339
Saponaria ocymoides,0,1,1,1.0,1.0
Saponaria officinalis,7,57,64,0.5924626954817165,0.5305954557942802
Sarcobatus vermiculatus,0,1,1,1.0,1.0
Sarcodes sanguinea,145,3210,3355,3.696492472836477e-83,1.3521014841115358e-63
Sarcodon imbricatus,0,5,5,1.0,0.7760428250025136
Sarcodon squamosus,1,1,2,0.2685730424867646,0.6723203844978234
Sarcosphaera coronaria,1,37,38,0.03563497956271764,0.06506592507691755
Sargus viridis,0,1,1,1.0,1.0
Sassacus papenhoei,1,0,1,0.14476460320460613,0.3126936942061339
Satyrium behrii,2,56,58,0.01363462779257556,0.027758022969630657
Satyrium calanus,1,1,2,0.2685730424867646,0.6723203844978234
Satyrium fuliginosa,0,21,21,0.06152025756350138,0.11517086832716916
Saucrobotys fumoferalis,0,1,1,1.0,1.0
Sauromalus ater,0,1,1,1.0,1.0
Sawadaea bicornis,1,0,1,0.14476460320460613,0.3126936942061339
Saxinis saucia,0,2,2,1.0,1.0
Sayornis nigricans,30,32,62,2.3940396141354086e-10,1.270385968931335e-13
Sayornis saya,3,7,10,0.16639035724257725,0.3442511672283348
Scaeva affinis,2,16,18,1.0,0.9435167712853587
Scandix pecten-veneris,1,1,2,0.2685730424867646,0.6723203844978234
Scantius aegyptius,1,0,1,0.14476460320460613,0.3126936942061339
Scapanus latimanus,7,24,31,0.20058628380882843,0.30430812278167974
Scaphinotus interruptus,1,0,1,0.14476460320460613,0.3126936942061339
Scathophaga stercoraria,0,13,13,0.23752623411074927,0.27601031745794824
Sceliphron caementarium,4,5,9,0.030121806187693938,0.03739180706614353
Sceloporus graciosus,48,421,469,0.008432207698686408,0.010827539448644632
Sceloporus occidentalis,225,733,958,1.1483513798490367e-13,2.814789587783476e-15
Sceloporus uniformis,3,2,5,0.02413002787627292,0.023975245305455268
Sceptridium multifidum,1,92,93,1.1913998435036246e-05,0.0004212611318475434
Schinia acutilinea,1,19,20,0.3447987554750399,0.37521694522958526
Schinia perminuta,0,5,5,1.0,0.7760428250025136
Schinia suetus,0,3,3,1.0,1.0
Schinia vacciniae,0,8,8,0.6124215574698968,0.5084255632839996
Schistocerca lineata,7,1,8,9.303494096827296e-06,7.976934310518629e-08
Schistocerca nitens,1,0,1,0.14476460320460613,0.3126936942061339
Schistocerca shoshone,2,0,2,0.0209561639230412,0.01499159650771353
Schizocosa mccooki,2,1,3,0.056801432979852025,0.0803492820202322
Schizophyllum commune,17,5,22,6.780752553295868e-11,7.124286572507333e-16
Schizotechium jamesianum,3,28,31,0.6120501383333876,0.6141187291654486
Schlettererius cinctipes,1,5,6,1.0,1.0
Schoenoplectus acutus,2,1,3,0.056801432979852025,0.0803492820202322
Schoenoplectus subterminalis,0,1,1,1.0,1.0
Scirpus microcarpus,4,16,20,0.519112689646881,0.7007507078681314
Sciurus griseus,279,292,571,1.2101031324047333e-84,2.4276189032642768e-120
Sciurus niger,0,1,1,1.0,1.0
Sclerocactus polyancistrus,0,3,3,1.0,1.0
Scleroderma areolatum,1,0,1,0.14476460320460613,0.3126936942061339
Scleroderma citrinum,0,1,1,1.0,1.0
Scleroderma polyrhizum,1,5,6,1.0,1.0
Scleropodium obtusifolium,1,0,1,0.14476460320460613,0.3126936942061339
Sclerotinia veratri,0,6,6,0.6025804396089913,0.6688993551184468
Scoliopteryx libatrix,0,3,3,1.0,1.0
Scolopendra polymorpha,2,2,4,0.10278607328810296,0.1906437976216683
Scolopocryptops gracilis,1,2,3,0.3744588472376553,0.9141432822130974
Scolopocryptops spinicaudus,0,2,2,1.0,1.0
Scopula ancellata,0,1,1,1.0,1.0
Scopula junctaria,0,10,10,0.3757244358299004,0.39438447212016514
Scopula luteolata,0,2,2,1.0,1.0
Scopula sideraria,0,1,1,1.0,1.0
Scrophularia californica,5,14,19,0.18025928610181918,0.2539885128379542
Scrophularia desertorum,0,8,8,0.6124215574698968,0.5084255632839996
Scudderia furcata,0,1,1,1.0,1.0
Scutellaria bolanderi,2,0,2,0.0209561639230412,0.01499159650771353
Scutellaria californica,10,31,41,0.07672041627054446,0.113575017842819
Scutellaria galericulata,0,11,11,0.38449278358904854,0.3492157200022511
Scutellaria siphocampyloides,4,5,9,0.030121806187693938,0.03739180706614353
Scutellaria tuberosa,3,9,12,0.3994183286503844,0.5314104390489738
Scutellinia scutellata,2,5,7,0.2688137426846044,0.6011437582684053
Scutiger pes-caprae,2,0,2,0.0209561639230412,0.01499159650771353
Scutigera coleoptrata,9,2,11,1.1607551894565098e-06,3.2337159071325644e-09
Scytinium palmatum,4,0,4,0.00043910829886184923,3.314336839661014e-05
Scytodes thoracica,0,2,2,1.0,1.0
Sedecula pulvinata,0,7,7,0.6034645370398923,0.5813304975648097
Sedella pumila,3,4,7,0.0674516701814297,0.11027569540283454
Sedum albomarginatum,1,0,1,0.14476460320460613,0.3126936942061339
Sedum album,0,3,3,1.0,1.0
Sedum lanceolatum,1,44,45,0.01706323185869589,0.033615273224393054
Sedum obtusatum,0,306,306,2.3572836827410997e-21,1.069595816942239e-12
Sedum paradisum,0,29,29,0.016473723171988544,0.05095618599691111
Sedum radiatum,1,0,1,0.14476460320460613,0.3126936942061339
Sedum spathulifolium,109,130,239,9.771298870221955e-31,4.357142291782888e-42
Seiurus aurocapilla,0,1,1,1.0,1.0
Selaginella hansenii,24,6,30,1.7242689589951008e-15,2.7622354425617334e-23
Selaginella wallacei,4,2,6,0.005153189017352294,0.0022646484484871816
Selaginella watsonii,3,46,49,0.10579550194137272,0.1445281512019976
Selasphorus calliope,5,49,54,0.33690383926577444,0.37007585967026546
Selasphorus platycercus,1,0,1,0.14476460320460613,0.3126936942061339
Selasphorus rufus,6,45,51,0.693907352611162,0.725255933012846
Selenocheir sinuata,5,0,5,6.355973818199171e-05,1.5903757301150513e-06
Semanotus amethystinus,3,17,20,1.0,1.0
Semanotus amplus,1,1,2,0.2685730424867646,0.6723203844978234
Senecio aronicoides,3,18,21,1.0,1.0
Senecio clarkianus,0,5,5,1.0,0.7760428250025136
Senecio flaccidus,1,1,2,0.2685730424867646,0.6723203844978234
Senecio fremontii,0,15,15,0.14994170356869613,0.21998124924271661
Senecio hydrophilus,0,11,11,0.38449278358904854,0.3492157200022511
Senecio integerrimus,1,225,226,3.027919545642935e-14,3.529760948425593e-09
Senecio pattersonensis,0,1,1,1.0,1.0
Senecio scorzonella,0,12,12,0.2360424886052977,0.31009055076592434
Senecio serra,0,6,6,0.6025804396089913,0.6688993551184468
Senecio spartioides,1,1,2,0.2685730424867646,0.6723203844978234
Senecio triangularis,1,341,342,4.879196636545306e-22,1.531245852879026e-13
Senecio vulgaris,6,0,6,9.199825086801498e-06,7.715317253706965e-08
Sequoiadendron giganteum,42,2755,2797,1.874800528452459e-130,1.1694455891734926e-85
Sergiolus columbianus,0,1,1,1.0,1.0
Sericocarpus californicus,0,9,9,0.37460992252836506,0.4468858706621094
Sericocarpus oregonensis,1,14,15,0.7118339050632088,0.6221922979706558
Sericomyia chalcopyga,0,3,3,1.0,1.0
Sericomyia flagrans,1,5,6,1.0,1.0
Sericosema juturnaria,0,5,5,1.0,0.7760428250025136
Serpula himantioides,0,4,4,1.0,0.9105509465652237
Serradigitus gertschi,3,1,4,0.010816792675262966,0.00633924523846032
Sesia tibiale,0,5,5,1.0,0.7760428250025136
Setagrotis pallidicollis,2,6,8,0.3262180684327187,0.7311980927864552
Setophaga auduboni,12,138,150,0.02025482252352028,0.03242961543719287
Setophaga caerulescens,0,1,1,1.0,1.0
Setophaga coronata,31,344,375,0.0003929232432072372,0.0008158009015254102
Setophaga graciae,1,2,3,0.3744588472376553,0.9141432822130974
Setophaga nigrescens,10,60,70,1.0,1.0
Setophaga occidentalis,10,121,131,0.02467973671926314,0.035516992113900595
Setophaga pensylvanica,0,2,2,1.0,1.0
Setophaga petechia,6,40,46,1.0,0.9468159180884836
Setophaga ruticilla,0,1,1,1.0,1.0
Setophaga townsendi,3,12,15,0.46864155961299403,0.8094879786929297
Sherardia arvensis,8,0,8,1.9272389244988723e-07,1.8600410733089334e-10
Sialia currucoides,0,121,121,1.279502557646495e-08,1.0934619828509567e-05
Sialia mexicana,77,121,198,3.096773813108104e-17,4.182485439459425e-22
Sialis nevadensis,2,3,5,0.15522343689242213,0.32387652224382535
Sibbaldia procumbens,0,33,33,0.010891466813681657,0.034323099218764155
Sicya crocearia,0,5,5,1.0,0.7760428250025136
Sicya macularia,0,2,2,1.0,1.0
Sicya morsicaria,0,3,3,1.0,1.0
Sidalcea asprella,11,4,15,4.5174956785257664e-07,9.85475324450596e-10
Sidalcea covillei,0,2,2,1.0,1.0
Sidalcea gigantea,0,2,2,1.0,1.0
Sidalcea glaucescens,2,262,264,2.3585278788653558e-15,4.0595267058467187e-10
Sidalcea hartwegii,2,0,2,0.0209561639230412,0.01499159650771353
Sidalcea multifida,1,5,6,1.0,1.0
Sidalcea oregana,2,219,221,1.0417964412549075e-12,1.686156981895173e-08
Sidalcea reptans,0,1,1,1.0,1.0
Sidalcea robusta,1,1,2,0.2685730424867646,0.6723203844978234
Sigmocheir calaveras,2,0,2,0.0209561639230412,0.01499159650771353
Sigmocheir furcata,2,0,2,0.0209561639230412,0.01499159650771353
Silene aperta,0,1,1,1.0,1.0
Silene bernardina,0,15,15,0.14994170356869613,0.21998124924271661
Silene bridgesii,0,1,1,1.0,1.0
Silene coronaria,50,70,120,4.43904361277633e-13,7.565109300658929e-17
Silene douglasii,0,74,74,1.710853674765877e-05,0.0007391339501106691
Silene gallica,4,0,4,0.00043910829886184923,3.314336839661014e-05
Silene invisa,0,3,3,1.0,1.0
Silene laciniata,273,231,504,2.4783911724202546e-96,3.860446766206519e-141
Silene latifolia,0,1,1,1.0,1.0
Silene lemmonii,10,142,152,0.003715303083045447,0.007979263629526534
Silene menziesii,0,8,8,0.6124215574698968,0.5084255632839996
Silene nuda,0,1,1,1.0,1.0
Silene nutans,0,1,1,1.0,1.0
Silene occidentalis,0,5,5,1.0,0.7760428250025136
Silene sargentii,0,21,21,0.06152025756350138,0.11517086832716916
Silene verecunda,2,0,2,0.0209561639230412,0.01499159650771353
Silvius gigantulus,1,7,8,1.0,1.0
Silybum marianum,4,2,6,0.005153189017352294,0.0022646484484871816
Sinodendron rugosum,1,5,6,1.0,1.0
Siphateles bicolor,0,14,14,0.24486350799097997,0.24618548812479032
Sirex behrensii,0,1,1,1.0,1.0
Sirex californicus,0,1,1,1.0,1.0
Sirex longicauda,0,2,2,1.0,1.0
Sirex varipes,0,4,4,1.0,0.9105509465652237
Sisymbrium altissimum,1,5,6,1.0,1.0
Sisymbrium irio,0,1,1,1.0,1.0
Sisyrinchium bellum,15,44,59,0.02470326231040998,0.02744645001243381
Sisyrinchium californicum,1,4,5,0.5424646889787644,1.0
Sisyrinchium elmeri,0,5,5,1.0,0.7760428250025136
Sisyrinchium idahoense,0,8,8,0.6124215574698968,0.5084255632839996
Sitones californius,0,1,1,1.0,1.0
Sitta canadensis,25,356,381,1.8517790954561644e-06,1.5461946974592542e-05
Sitta carolinensis,29,173,202,1.0,1.0
Sitta pygmaea,8,84,92,0.13728260959762334,0.15328929213393064
Smerinthus cerisyi,3,77,80,0.0036633784041117095,0.010220339278119788
Smilax californica,7,3,10,0.00010655132026942219,5.604574097560587e-06
Smithiastrum prenanthoides,31,199,230,0.7782733369855827,0.7363173715386457
Solanum americanum,2,6,8,0.3262180684327187,0.7311980927864552
Solanum angustifolium,3,2,5,0.02413002787627292,0.023975245305455268
Solanum dulcamara,3,0,3,0.0030335293929702875,0.000700171082788584
Solanum nigrum,1,1,2,0.2685730424867646,0.6723203844978234
Solanum nitidibaccatum,0,1,1,1.0,1.0
Solanum scabrum,0,1,1,1.0,1.0
Solanum triflorum,0,4,4,1.0,0.9105509465652237
Solanum tuberosum,2,1,3,0.056801432979852025,0.0803492820202322
Solanum umbelliferum,9,31,40,0.17274555959595206,0.22336433076603895
Solidago californica,1,0,1,0.14476460320460613,0.3126936942061339
Solidago elongata,0,19,19,0.09746384240092232,0.14226189947649115
Solidago multiradiata,0,49,49,0.0008005248515112549,0.007422022401504626
Solidago spectabilis,0,7,7,0.6034645370398923,0.5813304975648097
Solidago velutina,3,8,11,0.2054644031680506,0.4367258119699784
Soliva sessilis,1,0,1,0.14476460320460613,0.3126936942061339
Somatochlora semicircularis,0,12,12,0.2360424886052977,0.31009055076592434
Sonchus asper,4,5,9,0.030121806187693938,0.03739180706614353
Sonchus oleraceus,1,1,2,0.2685730424867646,0.6723203844978234
Sorbus californica,2,40,42,0.0793097294352596,0.11637760356200023
Sorbus scopulina,0,6,6,0.6025804396089913,0.6688993551184468
Sorbus sitchensis,0,3,3,1.0,1.0
Sorex monticolus,0,1,1,1.0,1.0
Sorex ornatus,0,1,1,1.0,1.0
Sorex palustris,0,2,2,1.0,1.0
Sorex vagrans,1,1,2,0.2685730424867646,0.6723203844978234
Sorghum halepense,1,0,1,0.14476460320460613,0.3126936942061339
Sowerbyella rhenana,1,0,1,0.14476460320460613,0.3126936942061339
Sparassis radicata,4,1,5,0.0019413025415773043,0.00041787713651955216
Sparaxis tricolor,3,0,3,0.0030335293929702875,0.000700171082788584
Spargania magnoliata,0,7,7,0.6034645370398923,0.5813304975648097
Sparganium angustifolium,0,10,10,0.3757244358299004,0.39438447212016514
Sparganium emersum,0,1,1,1.0,1.0
Sparganothis senecionana,0,1,1,1.0,1.0
Spartium junceum,12,2,14,5.776306606320184e-09,6.210056186652793e-13
Spatula clypeata,0,1,1,1.0,1.0
Spatula cyanoptera,0,6,6,0.6025804396089913,0.6688993551184468
Spatula discors,0,1,1,1.0,1.0
Spea intermontana,1,5,6,1.0,1.0
Spergularia rubra,1,17,18,0.5002083905620196,0.4588452058316618
Speyeria atlantis,0,20,20,0.10203106758234803,0.12794167189413608
Speyeria callippe,10,47,57,0.45554961842872654,0.6383448031900922
Speyeria cybele,0,34,34,0.011544912843706439,0.03112496262794068
Speyeria egleis,1,46,47,0.011148967376321761,0.027877287437882547
Speyeria hydaspe,3,92,95,0.0006202654763659428,0.0027877015587676433
Speyeria mormonia,2,98,100,4.5936311485724e-05,0.0006626435454379266
Speyeria nokomis,0,5,5,1.0,0.7760428250025136
Speyeria zerene,1,63,64,0.0010324574951009714,0.005798708376138559
Sphaeralcea ambigua,1,25,26,0.16397356670156135,0.20698867318680708
Sphaeralcea grossulariifolia,0,1,1,1.0,1.0
Sphaerobolus stellatus,1,8,9,1.0,1.0
Sphaerophoria sulphuripes,0,4,4,1.0,0.9105509465652237
Sphaeropthalma edwardsii,0,1,1,1.0,1.0
Sphaeropthalma unicolor,1,3,4,0.4650164385481151,1.0
Sphaerostilbella aurifila,1,1,2,0.2685730424867646,0.6723203844978234
Sphagnum fuscum,0,1,1,1.0,1.0
Sphagnum squarrosum,0,1,1,1.0,1.0
Sphalma quadricollis,1,0,1,0.14476460320460613,0.3126936942061339
Spharagemon bunites,0,1,1,1.0,1.0
Sphecomyia dyari,0,1,1,1.0,1.0
Sphex ichneumoneus,2,16,18,1.0,0.9435167712853587
Sphex lucae,0,3,3,1.0,1.0
Sphinx chersis,1,0,1,0.14476460320460613,0.3126936942061339
Sphinx drupiferarum,0,5,5,1.0,0.7760428250025136
Sphinx perelegans,2,38,40,0.11284233848177294,0.13919060194328642
Sphinx sequoiae,5,24,29,0.6007226089024453,0.8734323932638586
Sphinx vashti,0,57,57,0.00021966229870961306,0.0035185750074501754
Sphiximorpha cylindrica,0,3,3,1.0,1.0
Sphyrapicus nuchalis,1,4,5,0.5424646889787644,1.0
Sphyrapicus ruber,23,258,281,0.001654742340152967,0.003561678419063391
Sphyrapicus thyroideus,4,214,218,2.313248784700982e-10,1.8754670015598377e-07
Sphyrapicus varius,0,1,1,1.0,1.0
Spilogale gracilis,1,7,8,1.0,1.0
Spilosoma vagans,1,85,86,4.062370455290401e-05,0.0007895990337725976
Spilosoma vestalis,3,15,18,0.7373365905564824,1.0
Spinus lawrencei,19,29,48,1.8325010778807485e-05,2.1474987021467734e-06
Spinus pinus,4,49,53,0.17477491125068229,0.21547241452622465
Spinus psaltria,61,59,120,6.7677566292130346e-21,4.434924995256348e-29
Spinus tristis,2,1,3,0.056801432979852025,0.0803492820202322
Spiraea douglasii,0,29,29,0.016473723171988544,0.05095618599691111
Spiraea japonica,0,1,1,1.0,1.0
Spiraea splendens,1,727,728,6.008949285624299e-48,5.755578741116513e-28
Spiranthes perexilis,0,12,12,0.2360424886052977,0.31009055076592434
Spiranthes porrifolia,0,7,7,0.6034645370398923,0.5813304975648097
Spiranthes romanzoffiana,1,69,70,0.0004711788562697498,0.0033548616984253815
Spiranthes stellata,0,43,43,0.00188367039695229,0.013084970189199272
Spizella breweri,1,14,15,0.7118339050632088,0.6221922979706558
Spizella passerina,11,125,136,0.037141022881667755,0.04592264407226578
Spodocybe trulliformis,0,1,1,1.0,1.0
Spodolepis substriataria,0,2,2,1.0,1.0
Spodoptera praefica,0,1,1,1.0,1.0
Spongiporus perdelicatus,0,2,2,1.0,1.0
Stachys ajugoides,0,24,24,0.03967208129449859,0.08442030606095953
Stachys albens,5,34,39,1.0,0.9470856405572265
Stachys byzantina,0,2,2,1.0,1.0
Stachys pycnantha,0,1,1,1.0,1.0
Stachys rigida,0,4,4,1.0,0.9105509465652237
Stagmomantis californica,1,0,1,0.14476460320460613,0.3126936942061339
Stagmomantis limbata,29,17,46,6.119481733908998e-14,5.533893028522397e-20
Stagnicola perplexa,0,2,2,1.0,1.0
Stamnoctenis pearsalli,0,6,6,0.6025804396089913,0.6688993551184468
Stamnodes marmorata,1,38,39,0.036658892545794367,0.059174927856222845
Stamnodes modocata,0,1,1,1.0,1.0
Stamnodes tessellata,2,12,14,1.0,1.0
Stanleya elata,0,1,1,1.0,1.0
Stanleya pinnata,0,4,4,1.0,0.9105509465652237
Steatoda grossa,1,0,1,0.14476460320460613,0.3126936942061339
Steatoda hespera,0,1,1,1.0,1.0
Steatoda nobilis,0,3,3,1.0,1.0
Steatoda triangulosa,0,1,1,1.0,1.0
Steccherinum fimbriatum,1,0,1,0.14476460320460613,0.3126936942061339
Steccherinum ochraceum,0,1,1,1.0,1.0
Stelgidopteryx serripennis,2,9,11,0.6666373202113602,1.0
Stellaria calycantha,0,1,1,1.0,1.0
Stellaria longipes,0,77,77,1.1303749296380957e-05,0.0005627632808601638
Stellaria media,17,5,22,6.780752553295868e-11,7.124286572507333e-16
Stellaria obtusa,0,1,1,1.0,1.0
Stellaria sitchana,0,2,2,1.0,1.0
Stemonitopsis typhina,0,1,1,1.0,1.0
Stenamma punctatoventre,0,1,1,1.0,1.0
Steniolia tibialis,0,2,2,1.0,1.0
Stenocolus scutellaris,1,0,1,0.14476460320460613,0.3126936942061339
Stenocorus vestitus,0,1,1,1.0,1.0
Stenodema trispinosa,0,1,1,1.0,1.0
Stenostrophia coquilletti,0,3,3,1.0,1.0
Stenostrophia tribalteata,0,17,17,0.15747128520432685,0.17645428752866515
Stenotus acaulis,0,53,53,0.0005536215528339737,0.005104113735423727
Stephanomeria cichoriacea,1,0,1,0.14476460320460613,0.3126936942061339
Stephanomeria exigua,2,3,5,0.15522343689242213,0.32387652224382535
Stephanomeria lactucina,1,87,88,2.6751186736278162e-05,0.0006596880395101647
Stephanomeria pauciflora,0,1,1,1.0,1.0
Stephanomeria tenuifolia,0,5,5,1.0,0.7760428250025136
Stereum hirsutum,40,15,55,3.1770622815057954e-22,1.2288887560278657e-33
Stereum ochraceoflavum,3,2,5,0.02413002787627292,0.023975245305455268
Sterna forsteri,0,1,1,1.0,1.0
Stictis radiata,2,0,2,0.0209561639230412,0.01499159650771353
Stonemyia fera,0,1,1,1.0,1.0
Stratiomys maculosa,0,2,2,1.0,1.0
Streptanthus cordatus,9,51,60,0.8548499676392711,1.0
Streptanthus coulteri,3,3,6,0.0431068667335647,0.05837521372070738
Streptanthus crassicaulis,3,6,9,0.12984024511270734,0.25675213762300036
Streptanthus diversifolius,3,3,6,0.0431068667335647,0.05837521372070738
Streptanthus farnsworthianus,7,13,20,0.018264373829709947,0.021970143577670128
Streptanthus fenestratus,0,4,4,1.0,0.9105509465652237
Streptanthus glaucus,1,0,1,0.14476460320460613,0.3126936942061339
Streptanthus gracilis,1,2,3,0.3744588472376553,0.9141432822130974
Streptanthus longirostris,0,1,1,1.0,1.0
Streptanthus longisiliquus,3,3,6,0.0431068667335647,0.05837521372070738
Streptanthus major,0,1,1,1.0,1.0
Streptanthus oliganthus,0,1,1,1.0,1.0
Streptanthus pilosus,10,21,31,0.009690146969955283,0.010507034311782097
Streptanthus polygaloides,9,16,25,0.006296445034677228,0.005528959050071479
Streptanthus tortuosus,21,716,737,2.314802074523536e-26,4.067815376027969e-19
Streptocephalus coloradensis,0,2,2,1.0,1.0
Streptopelia decaocto,5,13,18,0.1671443647859852,0.20445958898162533
Streptopus amplexifolius,1,4,5,0.5424646889787644,1.0
Strigosella africana,0,1,1,1.0,1.0
Strix nebulosa,3,21,24,1.0,1.0
Strix occidentalis,7,46,53,1.0,0.9462958973645774
Strix varia,0,2,2,1.0,1.0
Strobilurus albipilatus,0,13,13,0.23752623411074927,0.27601031745794824
Strobilurus diminutivus,1,5,6,1.0,1.0
Strobilurus trullisatus,14,7,21,7.473486977636166e-08,8.734709704748756e-11
Stropenron nigricollis,0,2,2,1.0,1.0
Stropharia aeruginosa,1,0,1,0.14476460320460613,0.3126936942061339
Stropharia ambigua,48,24,72,1.0170043174305123e-23,2.0202219941109983e-35
Stropharia kauffmanii,0,1,1,1.0,1.0
Strophiona nitens,0,1,1,1.0,1.0
Strophiona tigrina,0,9,9,0.37460992252836506,0.4468858706621094
Struthiopteris spicant,0,11,11,0.38449278358904854,0.3492157200022511
Strymon acadica,9,48,57,0.7084992520181175,0.9254854879484593
Strymon melinus,16,42,58,0.008188908625306902,0.008018464707064389
Strymon saepium,5,118,123,0.0002848459001700759,0.0016078695941982358
Strymon sylvinus,4,73,77,0.014977309238449936,0.03130361404403097
Sturnella neglecta,1,7,8,1.0,1.0
Sturnus vulgaris,2,7,9,0.6270956953788205,0.8518628753529384
Stylurus olivaceus,0,2,2,1.0,1.0
Styrax redivivus,30,4,34,1.6544060916256537e-21,4.502727846685162e-33
Subularia aquatica,0,1,1,1.0,1.0
Suillia barberi,0,1,1,1.0,1.0
Suillus americanus,0,7,7,0.6034645370398923,0.5813304975648097
Suillus borealis,0,1,1,1.0,1.0
Suillus brevipes,0,46,46,0.0012259858395540608,0.009846047105553002
Suillus brunnescens,3,0,3,0.0030335293929702875,0.000700171082788584
Suillus caerulescens,15,8,23,3.9241361889745834e-08,3.592502858691397e-11
Suillus flavidus,0,6,6,0.6025804396089913,0.6688993551184468
Suillus fuscotomentosus,34,27,61,7.618841116964356e-14,2.7540418250162065e-19
Suillus lakei,4,10,14,0.1328770537680288,0.26309932517491896
Suillus pseudobrevipes,2,11,13,1.0,1.0
Suillus punctatipes,0,1,1,1.0,1.0
Suillus pungens,1,0,1,0.14476460320460613,0.3126936942061339
Suillus subalpinus,0,1,1,1.0,1.0
Suillus tomentosus,2,24,26,0.5732761753112863,0.4811289201701078
Suillus umbonatus,0,2,2,1.0,1.0
Sus scrofa,1,2,3,0.3744588472376553,0.9141432822130974
Swertia perennis,3,6,9,0.12984024511270734,0.25675213762300036
Sylvanelater furtivus,1,0,1,0.14476460320460613,0.3126936942061339
Sylvilagus audubonii,1,3,4,0.4650164385481151,1.0
Sylvilagus nuttallii,0,33,33,0.010891466813681657,0.034323099218764155
Symmorphus projectus,0,1,1,1.0,1.0
Sympetrum corruptum,17,76,93,0.3012112030581005,0.37068463492379833
Sympetrum costiferum,0,1,1,1.0,1.0
Sympetrum danae,0,4,4,1.0,0.9105509465652237
Sympetrum illotum,6,6,12,0.0038645835637426216,0.002020624115740119
Sympetrum madidum,4,22,26,0.783753333771702,1.0
Sympetrum obtrusum,0,10,10,0.3757244358299004,0.39438447212016514
Sympetrum pallipes,8,100,108,0.03895679623985854,0.05098025956795296
Sympetrum semicinctum,0,39,39,0.0046877939621657125,0.019179555698833974
Sympetrum vicinum,1,4,5,0.5424646889787644,1.0
Symphoricarpos albus,6,9,15,0.014202389485018597,0.014582554383236133
Symphoricarpos longiflorus,1,11,12,1.0,0.845714857147599
Symphoricarpos mollis,5,134,139,5.097528553110456e-05,0.0004218335992250178
Symphoricarpos rotundifolius,2,98,100,4.5936311485724e-05,0.0006626435454379266
Symphyotrichum ascendens,0,5,5,1.0,0.7760428250025136
Symphyotrichum bracteolatum,0,16,16,0.15161267346782015,0.19687992504129675
Symphyotrichum chilense,4,3,7,0.0106471288054473,0.007559096939159896
Symphyotrichum foliaceum,0,5,5,1.0,0.7760428250025136
Symphyotrichum frondosum,0,3,3,1.0,1.0
Symphyotrichum lanceolatum,0,1,1,1.0,1.0
Symphyotrichum spathulatum,0,16,16,0.15161267346782015,0.19687992504129675
Sympistis bakeri,0,1,1,1.0,1.0
Sympistis deceptiva,0,1,1,1.0,1.0
Sympistis fifia,0,1,1,1.0,1.0
Sympistis homogena,0,1,1,1.0,1.0
Sympistis kelloggi,0,1,1,1.0,1.0
Sympistis nigrocaput,0,1,1,1.0,1.0
Sympistis orbicularis,0,1,1,1.0,1.0
Sympistis umbrifascia,0,3,3,1.0,1.0
Synanthedon bibionipennis,0,5,5,1.0,0.7760428250025136
Synanthedon chrysidipennis,0,2,2,1.0,1.0
Synanthedon mellinipennis,0,1,1,1.0,1.0
Synanthedon novaroensis,0,3,3,1.0,1.0
Synanthedon polygoni,0,5,5,1.0,0.7760428250025136
Synaphaeta guexi,5,2,7,0.0010327341762908842,0.00018014051424031924
Synaxis brunneilinearia,0,4,4,1.0,0.9105509465652237
Synaxis jubararia,1,1,2,0.2685730424867646,0.6723203844978234
Synaxis pallulata,0,1,1,1.0,1.0
Synchlora bistriaria,0,2,2,1.0,1.0
Synecdoche rubella,0,2,2,1.0,1.0
Synergus castanopsidis,0,21,21,0.06152025756350138,0.11517086832716916
Syngrapha celsa,0,4,4,1.0,0.9105509465652237
Syngrapha orophila,0,1,1,1.0,1.0
Syntomus americanus,0,1,1,1.0,1.0
Syntrichia princeps,0,2,2,1.0,1.0
Syntrichia ruralis,0,2,2,1.0,1.0
Syntrichopappus fremontii,0,1,1,1.0,1.0
Syringa vulgaris,1,2,3,0.3744588472376553,0.9141432822130974
Syritta flaviventris,0,1,1,1.0,1.0
Syrphus opinator,8,22,30,0.06784518550068121,0.10136858530694108
Tabanus punctifer,0,1,1,1.0,1.0
Tabuda planiceps,0,1,1,1.0,1.0
Tachycineta bicolor,0,20,20,0.10203106758234803,0.12794167189413608
Tachycineta thalassina,5,24,29,0.6007226089024453,0.8734323932638586
Tachyta falli,0,1,1,1.0,1.0
Tachytrechus sanus,0,1,1,1.0,1.0
Tadarida brasiliensis,0,3,3,1.0,1.0
Taeniatherum caput-medusae,1,1,2,0.2685730424867646,0.6723203844978234
Tamalia coweni,10,90,100,0.2544165729016433,0.25830730455604156
Tamias alpinus,0,7,7,0.6034645370398923,0.5813304975648097
Tamias amoenus,0,22,22,0.06301881478000051,0.10376364830846786
Tamias merriami,3,3,6,0.0431068667335647,0.05837521372070738
Tamias minimus,0,14,14,0.24486350799097997,0.24618548812479032
Tamias panamintinus,0,4,4,1.0,0.9105509465652237
Tamias quadrimaculatus,2,76,78,0.0010071258524364341,0.004659751314416274
Tamias senex,0,3,3,1.0,1.0
Tamias speciosus,1,134,135,2.55436854943786e-08,1.0105351513400026e-05
Tamias umbrinus,0,6,6,0.6025804396089913,0.6688993551184468
Tamiasciurus douglasii,38,865,903,7.721745224913391e-24,2.289270661025154e-18
Tanacetum parthenium,7,27,34,0.3256267639777223,0.44178241409064334
Tanacetum vulgare,0,18,18,0.0958116006335464,0.1583481410858158
Tanypteryx hageni,0,20,20,0.10203106758234803,0.12794167189413608
Taphrina californica,1,1,2,0.2685730424867646,0.6723203844978234
Taphrina deformans,1,1,2,0.2685730424867646,0.6723203844978234
Taphrina flectens,0,1,1,1.0,1.0
Taphrina occidentalis,4,17,21,0.532712657319933,0.7754435214629749
Taphrina populi-salicis,0,6,6,0.6025804396089913,0.6688993551184468
Tapinella atrotomentosa,0,2,2,1.0,1.0
Tapinella panuoides,2,1,3,0.056801432979852025,0.0803492820202322
Tapinoma sessile,6,23,29,0.29891263905232135,0.49202768878923264
Tarache flavipennis,0,2,2,1.0,1.0
Taraxacum ceratophorum,2,0,2,0.0209561639230412,0.01499159650771353
Taraxacum erythrospermum,1,0,1,0.14476460320460613,0.3126936942061339
Taraxacum officinale,17,94,111,0.787161316179036,0.9073905805249641
Taraxia subacaulis,0,22,22,0.06301881478000051,0.10376364830846786
Taraxia tanacetifolia,1,15,16,0.4958553183213633,0.5619415773454699
Targionia hypophylla,0,1,1,1.0,1.0
Taricha granulosa,1,1,2,0.2685730424867646,0.6723203844978234
Taricha sierrae,162,149,311,1.0416405581750326e-54,9.846888920748415e-79
Taricha torosa,6,3,9,0.0005200289628174682,7.003163864249939e-05
Tauschia hartwegii,19,5,24,2.280328244784785e-12,2.8501622346074248e-18
Tauschia parishii,1,0,1,0.14476460320460613,0.3126936942061339
Taxidea taxus,1,4,5,0.5424646889787644,1.0
Taxus brevifolia,11,116,127,0.07585966476809113,0.0824052344642421
Tebenna gemmalis,0,4,4,1.0,0.9105509465652237
Tegrodera latecincta,2,0,2,0.0209561639230412,0.01499159650771353
Telethusia ovalis,0,1,1,1.0,1.0
Teliapsocus conterminus,0,4,4,1.0,0.9105509465652237
Tellima grandiflora,18,44,62,0.0030794083927930547,0.0020887425406925834
Temnoscheila chlorodia,2,10,12,0.688979020593936,1.0
Tetracis cervinaria,0,13,13,0.23752623411074927,0.27601031745794824
Tetradymia canescens,6,32,38,0.816840754862324,1.0
Tetradymia tetrameres,0,1,1,1.0,1.0
Tetragnatha versicolor,1,0,1,0.14476460320460613,0.3126936942061339
Tetraleurodes perileuca,0,4,4,1.0,0.9105509465652237
Tetramelas concinnus,1,0,1,0.14476460320460613,0.3126936942061339
Tetraopes femoratus,0,5,5,1.0,0.7760428250025136
Tetrix subulata,0,1,1,1.0,1.0
Tetropium abietis,0,1,1,1.0,1.0
Thalictrum alpinum,2,4,6,0.21128172197002185,0.4637992200137968
Thalictrum fendleri,4,98,102,0.001014756540111092,0.0038572356443987922
Thalictrum occidentale,0,1,1,1.0,1.0
Thalictrum sparsiflorum,2,46,48,0.03931717494797546,0.06798299433391557
Thamnophis couchii,39,177,216,0.1459153010187782,0.16180533060975388
Thamnophis elegans,9,310,319,4.4330220377790074e-12,5.17945171068577e-09
Thamnophis sirtalis,4,49,53,0.17477491125068229,0.21547241452622465
Thanasimus undatulus,0,1,1,1.0,1.0
Thanatophilus lapponicus,0,1,1,1.0,1.0
Tharsalea arota,2,52,54,0.01921286499856012,0.03971157651878774
Tharsalea editha,0,130,130,2.192392455233734e-09,4.928378200822232e-06
Tharsalea gorgon,2,8,10,0.6456440117183423,0.9624710515030661
Tharsalea helloides,0,12,12,0.2360424886052977,0.31009055076592434
Tharsalea heteronea,0,25,25,0.04095412181173697,0.07622457957144455
Tharsalea mariposa,0,40,40,0.002903232974393092,0.017424485372976518
Tharsalea nivalis,0,91,91,1.370968655458839e-06,0.00015896397257726192
Tharsalea rubidus,0,26,26,0.025555133894118995,0.0688671495635685
Tharsalea xanthoides,4,1,5,0.0019413025415773043,0.00041787713651955216
Thaumatographa regalis,0,2,2,1.0,1.0
Thaxterogaster vibratilis,0,1,1,1.0,1.0
Theatops californiensis,11,37,48,0.10108590656077007,0.1451295388422685
Thecabius populiconduplifolius,0,1,1,1.0,1.0
Thecabius populimonilis,1,3,4,0.4650164385481151,1.0
Thecla chalcis,0,2,2,1.0,1.0
Thecla dryope,0,3,3,1.0,1.0
Thecla iroides,0,9,9,0.37460992252836506,0.4468858706621094
Thecla johnsoni,0,17,17,0.15747128520432685,0.17645428752866515
Thecla sheridanii,0,14,14,0.24486350799097997,0.24618548812479032
Thecodiplosis pinirigidae,0,1,1,1.0,1.0
Thelephora terrestris,0,1,1,1.0,1.0
Thelypodium crispum,0,1,1,1.0,1.0
Thelypodium integrifolium,0,1,1,1.0,1.0
Thelypodium laciniatum,1,2,3,0.3744588472376553,0.9141432822130974
Thessalia leanira,4,2,6,0.005153189017352294,0.0022646484484871816
Thevenetimyia celer,0,1,1,1.0,1.0
Thevenetimyia luctifera,0,1,1,1.0,1.0
Thinopyrum intermedium,2,7,9,0.6270956953788205,0.8518628753529384
Thlaspi arvense,0,6,6,0.6025804396089913,0.6688993551184468
Thomomys bottae,6,16,22,0.11926992136640324,0.16064992252718743
Thomomys monticola,0,7,7,0.6034645370398923,0.5813304975648097
Thorybes mexicana,0,28,28,0.02673836112705098,0.056309179680095994
Thorybes pylades,2,3,5,0.15522343689242213,0.32387652224382535
Thricolepis inornata,0,2,2,1.0,1.0
Thryomanes bewickii,4,9,13,0.10658251785953915,0.20215021085988086
Thyanta custator,2,3,5,0.15522343689242213,0.32387652224382535
Thyanta pallidovirens,1,1,2,0.2685730424867646,0.6723203844978234
Thymus pulegioides,1,0,1,0.14476460320460613,0.3126936942061339
Thyridanthrax atratus,1,0,1,0.14476460320460613,0.3126936942061339
Thysanocarpus curvipes,15,8,23,3.9241361889745834e-08,3.592502858691397e-11
Tilachlidium brachiatum,0,3,3,1.0,1.0
Tiquilia nuttallii,0,1,1,1.0,1.0
Titiotus heberti,1,0,1,0.14476460320460613,0.3126936942061339
Tmarus angulatus,0,1,1,1.0,1.0
Toiyabea eximia,0,3,3,1.0,1.0
Toiyabea peirsonii,0,7,7,0.6034645370398923,0.5813304975648097
Tolype distincta,0,3,3,1.0,1.0
Tomentellopsis echinospora,1,0,1,0.14476460320460613,0.3126936942061339
Tomostima cuneifolia,0,1,1,1.0,1.0
Tonella tenella,1,0,1,0.14476460320460613,0.3126936942061339
Torilis arvensis,5,3,8,0.0024244129099057063,0.0007850786162003298
Toripalpus trabalis,0,5,5,1.0,0.7760428250025136
Torreya californica,34,38,72,3.65047390476944e-11,1.0698064110979162e-14
Torreyochloa erecta,0,1,1,1.0,1.0
Tortistilus pacifica,3,0,3,0.0030335293929702875,0.000700171082788584
Townsendia condensata,3,4,7,0.0674516701814297,0.11027569540283454
Townsendia leptotes,2,0,2,0.0209561639230412,0.01499159650771353
Townsendia scapigera,0,18,18,0.0958116006335464,0.1583481410858158
Toxicodendron diversilobum,164,74,238,1.0548301865036022e-80,4.5286233287622434e-125
Toxicoscordion exaltatum,1,0,1,0.14476460320460613,0.3126936942061339
Toxicoscordion paniculatum,1,79,80,9.048658353492115e-05,0.001355767691014155
Toxicoscordion venenosum,3,25,28,0.78915667044639,0.7662746109484886
Toxomerus marginatus,7,12,19,0.01353143931457447,0.01449395234620175
Toxomerus occidentalis,6,5,11,0.002201136146005925,0.0008124952796229928
Toxostoma redivivum,1,0,1,0.14476460320460613,0.3126936942061339
Trachemys scripta,10,4,14,2.3010529812760674e-06,1.3738561767643127e-08
Trachykele blondeli,0,2,2,1.0,1.0
Trachykele nimbosa,0,1,1,1.0,1.0
Trachypachus gibbsii,0,3,3,1.0,1.0
Tragopogon dubius,16,199,215,0.0024701055049286104,0.004566879933356682
Tragopogon porrifolius,1,1,2,0.2685730424867646,0.6723203844978234
Tragosoma harrisii,1,43,44,0.01643618076915838,0.036921759051915914
Tragosoma pilosicornis,2,3,5,0.15522343689242213,0.32387652224382535
Tramea lacerata,4,1,5,0.0019413025415773043,0.00041787713651955216
Trametes hirsuta,1,0,1,0.14476460320460613,0.3126936942061339
Trametes versicolor,60,20,80,6.8250492883793824e-34,2.265841745355815e-52
Trautvetteria carolinensis,0,7,7,0.6034645370398923,0.5813304975648097
Tremella mesenterica,9,3,12,4.040097077097204e-06,2.881081634006637e-08
Triaenodes tardus,1,0,1,0.14476460320460613,0.3126936942061339
Triantha occidentalis,0,74,74,1.710853674765877e-05,0.0007391339501106691
Tribulus terrestris,3,0,3,0.0030335293929702875,0.000700171082788584
Tricardia watsonii,2,0,2,0.0209561639230412,0.01499159650771353
Trichaptum abietinum,3,22,25,1.0,0.9460168149437689
Trichaptum biforme,0,1,1,1.0,1.0
Trichaptum fuscoviolaceum,0,1,1,1.0,1.0
Tricharina gilva,0,1,1,1.0,1.0
Tricharina praecox,0,2,2,1.0,1.0
Trichia ambigua,0,1,1,1.0,1.0
Trichocnemis spiculatus,16,40,56,0.0064483928641057165,0.004982240674571551
Trichoderma atroviride,1,0,1,0.14476460320460613,0.3126936942061339
Trichoderma harzianum,0,1,1,1.0,1.0
Trichoderma viride,1,0,1,0.14476460320460613,0.3126936942061339
Trichodes ornatus,44,191,235,0.07714442388378824,0.07864118338812409
Trichodesma cristata,0,3,3,1.0,1.0
Tricholoma atroviolaceum,1,0,1,0.14476460320460613,0.3126936942061339
Tricholoma aurantium,1,0,1,0.14476460320460613,0.3126936942061339
Tricholoma dulciolens,0,1,1,1.0,1.0
Tricholoma equestre,2,1,3,0.056801432979852025,0.0803492820202322
Tricholoma focale,2,1,3,0.056801432979852025,0.0803492820202322
Tricholoma fracticum,0,1,1,1.0,1.0
Tricholoma manzanitae,3,0,3,0.0030335293929702875,0.000700171082788584
Tricholoma moseri,0,15,15,0.14994170356869613,0.21998124924271661
Tricholoma murrillianum,11,12,23,0.00014482738415327791,2.143068684694028e-05
Tricholoma pardinum,0,1,1,1.0,1.0
Tricholoma saponaceum,9,9,18,0.00038954749754674915,7.862760233596196e-05
Tricholoma subannulatum,1,0,1,0.14476460320460613,0.3126936942061339
Tricholoma terreum,0,3,3,1.0,1.0
Tricholoma ulvinenii,0,1,1,1.0,1.0
Tricholoma venenatoides,0,1,1,1.0,1.0
Tricholoma vernaticum,0,8,8,0.6124215574698968,0.5084255632839996
Tricholomopsis rutilans,0,9,9,0.37460992252836506,0.4468858706621094
Trichophorum pumilum,0,3,3,1.0,1.0
Trichoplusia ni,0,2,2,1.0,1.0
Trichordestra tacoma,0,1,1,1.0,1.0
Trichostema austromontanum,1,0,1,0.14476460320460613,0.3126936942061339
Trichostema lanceolatum,3,8,11,0.2054644031680506,0.4367258119699784
Trichostema oblongum,6,26,32,0.45268758260456926,0.66292011495846
Trichostema simulatum,2,0,2,0.0209561639230412,0.01499159650771353
Tridepia nova,1,0,1,0.14476460320460613,0.3126936942061339
Trifolium albopurpureum,1,4,5,0.5424646889787644,1.0
Trifolium andersonii,0,2,2,1.0,1.0
Trifolium beckwithii,0,1,1,1.0,1.0
Trifolium bifidum,0,1,1,1.0,1.0
Trifolium bolanderi,1,11,12,1.0,0.845714857147599
Trifolium breweri,4,12,16,0.2740043737810785,0.40028983280731434
Trifolium campestre,1,0,1,0.14476460320460613,0.3126936942061339
Trifolium ciliolatum,9,5,14,2.785639213432983e-05,8.786751400281266e-07
Trifolium cyathiferum,0,31,31,0.017533155988062814,0.04178605412471552
Trifolium dedeckerae,1,9,10,1.0,1.0
Trifolium depauperatum,3,0,3,0.0030335293929702875,0.000700171082788584
Trifolium dichotomum,1,0,1,0.14476460320460613,0.3126936942061339
Trifolium dubium,26,9,35,2.729653060547852e-15,9.537100458377321e-23
Trifolium glomeratum,0,1,1,1.0,1.0
Trifolium hirtum,34,26,60,3.9210571469278486e-14,8.568067890632283e-20
Trifolium hybridum,0,13,13,0.23752623411074927,0.27601031745794824
Trifolium incarnatum,7,0,7,1.3315701680073362e-06,3.775277184632102e-09
Trifolium lemmonii,0,5,5,1.0,0.7760428250025136
Trifolium longipes,0,166,166,8.841613700317973e-12,2.072641919952349e-07
Trifolium microcephalum,4,15,19,0.3433139456279959,0.6250673019802819
Trifolium monanthum,1,68,69,0.0004553104041091395,0.0036744741598103907
Trifolium obtusiflorum,4,7,11,0.06219290144309395,0.10212099408086615
Trifolium pratense,5,56,61,0.20255054429995678,0.22545548247406422
Trifolium productum,0,95,95,5.530142557160707e-07,0.00011100260986042169
Trifolium repens,5,46,51,0.4288950512327108,0.4535825160881831
Trifolium resupinatum,1,0,1,0.14476460320460613,0.3126936942061339
Trifolium striatum,1,0,1,0.14476460320460613,0.3126936942061339
Trifolium subterraneum,4,1,5,0.0019413025415773043,0.00041787713651955216
Trifolium variegatum,5,37,42,0.8266537362692452,0.7991669932033051
Trifolium willdenovii,40,14,54,1.0085473771817715e-22,1.5808922846383504e-34
Trifolium wormskioldii,8,36,44,0.5175415485806318,0.6281339487747692
Triglochin palustris,0,2,2,1.0,1.0
Triglyphulus ater,0,1,1,1.0,1.0
Trillium albidum,12,21,33,0.001527193229327743,0.000880265546734677
Trillium angustipetalum,22,70,92,0.016505904209742774,0.015317180124287977
Trillium chloropetalum,16,2,18,4.232639300581274e-12,5.7285803001238e-18
Trillium kurabayashii,10,7,17,2.936803960192685e-05,1.221505210441897e-06
Trilobopsis loricata,1,0,1,0.14476460320460613,0.3126936942061339
Trimerotropis albescens,0,3,3,1.0,1.0
Trimerotropis fontana,12,73,85,1.0,1.0
Trimerotropis pallidipennis,3,10,13,0.41916983303031286,0.626122924488651
Trimerotropis thalassica,1,0,1,0.14476460320460613,0.3126936942061339
Trimerotropis verruculata,5,167,172,6.678207120056837e-07,2.6023836564386877e-05
Tringa melanoleuca,0,1,1,1.0,1.0
Tringa semipalmata,0,1,1,1.0,1.0
Tringa solitaria,0,1,1,1.0,1.0
Triocnemis saporis,1,0,1,0.14476460320460613,0.3126936942061339
Triodanis perfoliata,0,1,1,1.0,1.0
Trioza frontalis,0,1,1,1.0,1.0
Triphosa californiata,1,0,1,0.14476460320460613,0.3126936942061339
Triphosa haesitata,2,27,29,0.4236909029353637,0.37010633316578956
Triphyllia elongatus,0,1,1,1.0,1.0
Triphysaria eriantha,12,2,14,5.776306606320184e-09,6.210056186652793e-13
Triphysaria versicolor,4,0,4,0.00043910829886184923,3.314336839661014e-05
Trirhabda pilosa,0,1,1,1.0,1.0
Triteleia bridgesii,23,11,34,2.7327951554134805e-12,1.0504627691056968e-17
Triteleia dudleyi,2,11,13,1.0,1.0
Triteleia hyacinthina,24,174,198,0.41823245397655306,0.40017188276220184
Triteleia ixioides,87,747,834,0.000651901353537728,0.001047394034274888
Triteleia laxa,22,13,35,7.270644233512425e-11,2.902541736817738e-15
Triteleia montana,0,53,53,0.0005536215528339737,0.005104113735423727
Triteleia piutensis,4,0,4,0.00043910829886184923,3.314336839661014e-05
Triticum aestivum,5,3,8,0.0024244129099057063,0.0007850786162003298
Troglodytes aedon,4,72,76,0.02099065052102168,0.033997345752620804
Troglodytes hiemalis,0,1,1,1.0,1.0
Troglodytes pacificus,8,58,66,0.7267203525377575,0.7121708853584463
Trogus edwardsii,0,3,3,1.0,1.0
Tropaeolum majus,0,1,1,1.0,1.0
Tropidischia xanthostoma,1,2,3,0.3744588472376553,0.9141432822130974
Trupanea bisetosa,0,1,1,1.0,1.0
Trupanea jonesi,0,1,1,1.0,1.0
Trypeta flaveola,0,1,1,1.0,1.0
Tsuga mertensiana,0,376,376,3.9048325931144347e-26,2.5322362818751095e-15
Tubaria furfuracea,5,3,8,0.0024244129099057063,0.0007850786162003298
Tubaria romagnesiana,0,1,1,1.0,1.0
Tuberolachnus salignus,1,0,1,0.14476460320460613,0.3126936942061339
Tubifera ferruginosa,0,1,1,1.0,1.0
Tubifera montana,0,1,1,1.0,1.0
Tuckermanopsis platyphylla,0,3,3,1.0,1.0
Tulosesus angulatus,0,2,2,1.0,1.0
Tulosesus impatiens,4,1,5,0.0019413025415773043,0.00041787713651955216
Turbinellus floccosus,3,22,25,1.0,0.9460168149437689
Turbinellus kauffmanii,0,14,14,0.24486350799097997,0.24618548812479032
Turdus migratorius,165,681,846,6.964977028485438e-05,3.863374827333679e-05
Turricula parryi,0,16,16,0.15161267346782015,0.19687992504129675
Turritis glabra,3,9,12,0.3994183286503844,0.5314104390489738
Tutelina similis,0,1,1,1.0,1.0
Tylopilus humilis,1,0,1,0.14476460320460613,0.3126936942061339
Typha latifolia,1,6,7,1.0,1.0
Typhula juncea,10,0,10,4.0368220512681146e-09,4.586479508074135e-13
Tyrannus verticalis,2,9,11,0.6666373202113602,1.0
Tyromyces amarus,11,18,29,0.001603605243409579,0.000880945776619794
Tyromyces leucospongius,0,39,39,0.0046877939621657125,0.019179555698833974
Tyto alba,0,1,1,1.0,1.0
Udea vacunalis,0,3,3,1.0,1.0
Ufeus satyricus,0,1,1,1.0,1.0
Ulmus pumila,0,2,2,1.0,1.0
Uloborus diversus,0,1,1,1.0,1.0
Ulochaetes leoninus,5,16,21,0.2153348364160998,0.36521497392958746
Ulolonche dilecta,0,1,1,1.0,1.0
Ulota crispa,0,1,1,1.0,1.0
Umbellularia californica,104,120,224,3.2864968987449e-30,1.488150960518412e-41
Umbilicaria americana,0,1,1,1.0,1.0
Umbilicaria hyperborea,0,2,2,1.0,1.0
Umbilicaria krascheninnikovii,0,1,1,1.0,1.0
Umbilicaria phaea,12,44,56,0.17970800340509113,0.1974519917223582
Umbilicaria polaris,0,1,1,1.0,1.0
Umbilicaria polyrrhiza,1,0,1,0.14476460320460613,0.3126936942061339
Umbilicaria torrefacta,0,1,1,1.0,1.0
Umbilicaria virginis,0,1,1,1.0,1.0
Uresiphita reversalis,10,2,12,2.0097456022740384e-07,1.9031792621558245e-10
Urocerus californicus,1,43,44,0.01643618076915838,0.036921759051915914
Urocitellus beldingi,0,132,132,2.3650095669697457e-09,4.129748647357227e-06
Uroctonus mordax,30,103,133,0.012939128192228692,0.01154069664011061
Urocyon cinereoargenteus,117,98,215,1.7207526739130654e-42,1.429541046237592e-61
Uromyces aureus,0,2,2,1.0,1.0
Ursus americanus,101,1097,1198,2.4333388689250607e-10,3.1418564031411607e-09
Urtica dioica,3,12,15,0.46864155961299403,0.8094879786929297
Urtica gracilis,1,4,5,0.5424646889787644,1.0
Uta stansburiana,11,24,35,0.012632663121226989,0.009046478116378697
Utacapnia sierra,0,4,4,1.0,0.9105509465652237
Utricularia intermedia,1,4,5,0.5424646889787644,1.0
Utricularia macrorhiza,0,5,5,1.0,0.7760428250025136
Utricularia minor,0,5,5,1.0,0.7760428250025136
Vaccinium cespitosum,0,19,19,0.09746384240092232,0.14226189947649115
Vaccinium macrocarpon,1,0,1,0.14476460320460613,0.3126936942061339
Vaccinium shastense,1,15,16,0.4958553183213633,0.5619415773454699
Vaccinium uliginosum,0,66,66,6.224445011594697e-05,0.001534757489456566
Valeriana californica,0,246,246,4.4446970489403935e-17,1.9367075852263856e-10
Vanessa annabella,3,93,96,0.0004149496111223001,0.0025560954438112377
Vanessa atalanta,5,18,23,0.36651245763594814,0.4879152632145384
Vanessa cardui,20,196,216,0.026115184158102045,0.03719491071406122
Vanessa virginiensis,15,92,107,1.0,1.0
Velella velella,0,1,1,1.0,1.0
Veluticeps fimbriata,0,3,3,1.0,1.0
Veratrum californicum,24,1486,1510,2.321957998535961e-69,4.479980048401506e-46
Verbascum blattaria,18,9,27,9.67628910016274e-10,1.0517141433902147e-13
Verbascum thapsus,73,425,498,0.8985290024334984,0.9585865641068672
Verbascum virgatum,4,4,8,0.01886984470142184,0.01861366248431812
Verbena bracteata,0,1,1,1.0,1.0
Verbena brasiliensis,1,0,1,0.14476460320460613,0.3126936942061339
Verbena lasiostachys,2,16,18,1.0,0.9435167712853587
Vermileo comstocki,0,1,1,1.0,1.0
Veromessor andrei,1,0,1,0.14476460320460613,0.3126936942061339
Veronica americana,11,80,91,0.654263528351722,0.6179809533349396
Veronica anagallis-aquatica,1,3,4,0.4650164385481151,1.0
Veronica arvensis,2,2,4,0.10278607328810296,0.1906437976216683
Veronica catenata,0,3,3,1.0,1.0
Veronica chamaedrys,1,0,1,0.14476460320460613,0.3126936942061339
Veronica cusickii,0,14,14,0.24486350799097997,0.24618548812479032
Veronica hederifolia,1,0,1,0.14476460320460613,0.3126936942061339
Veronica longifolia,0,1,1,1.0,1.0
Veronica officinalis,0,2,2,1.0,1.0
Veronica peregrina,1,2,3,0.3744588472376553,0.9141432822130974
Veronica persica,4,2,6,0.005153189017352294,0.0022646484484871816
Veronica scutellata,0,5,5,1.0,0.7760428250025136
Veronica serpyllifolia,3,98,101,0.00030237673561258455,0.001656422610604771
Veronica wormskjoldii,0,27,27,0.025685714280551247,0.06225570614991151
Verpa conica,4,26,30,1.0,1.0
Vesper purpurascens,0,8,8,0.6124215574698968,0.5084255632839996
Vespula acadica,0,7,7,0.6034645370398923,0.5813304975648097
Vespula alascensis,4,27,31,1.0,1.0
Vespula atropilosa,0,7,7,0.6034645370398923,0.5813304975648097
Vespula infernalis,0,1,1,1.0,1.0
Vespula pensylvanica,10,53,63,0.7203937305767608,0.8918026431494697
Vespula sulphurea,4,6,10,0.044556650138771095,0.06510377152388026
Vibrissea truncorum,0,2,2,1.0,1.0
Viburnum ellipticum,1,1,2,0.2685730424867646,0.6723203844978234
Viburnum opulus,0,1,1,1.0,1.0
Viburnum tinus,3,2,5,0.02413002787627292,0.023975245305455268
Vicia americana,27,100,127,0.04217515512778987,0.04064477007171031
Vicia eriocarpa,0,1,1,1.0,1.0
Vicia sativa,22,14,36,1.6119673069712255e-10,1.199960574014441e-14
Vicia villosa,18,5,23,1.2505113891080133e-11,4.5459606574757475e-17
Villa fulviana,0,2,2,1.0,1.0
Villa hypomelas,0,1,1,1.0,1.0
Villa lateralis,0,3,3,1.0,1.0
Vinca major,56,30,86,1.2365290534143069e-26,9.234871024781076e-40
Vinca minor,3,3,6,0.0431068667335647,0.05837521372070738
Viola adunca,6,131,137,0.0002256048696411639,0.0012018478693072842
Viola arvensis,1,1,2,0.2685730424867646,0.6723203844978234
Viola aurea,2,5,7,0.2688137426846044,0.6011437582684053
Viola bakeri,0,29,29,0.016473723171988544,0.05095618599691111
Viola beckwithii,0,43,43,0.00188367039695229,0.013084970189199272
Viola cuneata,0,6,6,0.6025804396089913,0.6688993551184468
Viola glabella,4,202,206,1.079809409419494e-09,5.259736677237906e-07
Viola lobata,84,611,695,0.0747037953022803,0.08187132544364811
Viola macloskeyi,1,268,269,3.8326992407779835e-17,8.4516359526942e-11
Viola odorata,15,10,25,1.9578470281837576e-07,6.205790436866936e-10
Viola pinetorum,10,231,241,3.0922043776497034e-07,7.914351299968718e-06
Viola praemorsa,0,60,60,0.00014378007469898363,0.002665672747563187
Viola purpurea,63,514,577,0.014961321383448335,0.01763427558551171
Viola quercetorum,6,1,7,5.640935459925577e-05,1.4388133744720056e-06
Viola riviniana,1,0,1,0.14476460320460613,0.3126936942061339
Viola sheltonii,57,133,190,4.0161018216456593e-08,2.2171150824216845e-09
Viola tomentosa,2,31,33,0.21893835641553538,0.2598647020176285
Viola tricolor,0,1,1,1.0,1.0
Vireo cassinii,5,58,63,0.15500524453625242,0.194822427716918
Vireo flavifrons,1,0,1,0.14476460320460613,0.3126936942061339
Vireo gilvus,9,90,99,0.152224087075373,0.1674519803215276
Vireo huttoni,4,9,13,0.10658251785953915,0.20215021085988086
Vireo plumbeus,0,11,11,0.38449278358904854,0.3492157200022511
Viscum album,0,2,2,1.0,1.0
Vitex agnus-castus,1,0,1,0.14476460320460613,0.3126936942061339
Vitis californica,14,1,15,2.2970506110575563e-11,9.312237791943351e-17
Vitis vinifera,1,0,1,0.14476460320460613,0.3126936942061339
Vitreoporus dichrous,1,0,1,0.14476460320460613,0.3126936942061339
Vitrina pellucida,0,1,1,1.0,1.0
Volvopluteus gloiocephalus,1,0,1,0.14476460320460613,0.3126936942061339
Vulpes macrotis,1,0,1,0.14476460320460613,0.3126936942061339
Vulpes vulpes,0,3,3,1.0,1.0
Vulpicida canadensis,12,17,29,0.0003915164444701709,0.00011629364572338143
Walshomyia juniperina,2,6,8,0.3262180684327187,0.7311980927864552
Wamokia hoffmani,0,1,1,1.0,1.0
Willistonina bilineata,0,1,1,1.0,1.0
Woodwardia fimbriata,85,74,159,1.4619044349555416e-30,1.0633453443501073e-43
Wyethia angustifolia,6,11,17,0.027184062695095077,0.03618509647236818
Wyethia helenioides,5,2,7,0.0010327341762908842,0.00018014051424031924
Wyethia helianthoides,0,2,2,1.0,1.0
Wyethia mollis,4,723,727,6.119676202467222e-43,1.97425200976015e-26
Wyethia sagittata,6,167,173,3.6933225099526504e-06,6.105532437377177e-05
Xanthippus corallipes,0,1,1,1.0,1.0
Xanthium orientale,1,0,1,0.14476460320460613,0.3126936942061339
Xanthium strumarium,2,0,2,0.0209561639230412,0.01499159650771353
Xanthocephalus xanthocephalus,0,11,11,0.38449278358904854,0.3492157200022511
Xanthochilus saturnius,4,9,13,0.10658251785953915,0.20215021085988086
Xanthochroina bicolor,2,9,11,0.6666373202113602,1.0
Xanthoepalpus bicolor,0,1,1,1.0,1.0
Xanthogaleruca luteola,0,1,1,1.0,1.0
Xanthoparmelia cumberlandia,2,0,2,0.0209561639230412,0.01499159650771353
Xanthorhoe decoloraria,0,1,1,1.0,1.0
Xanthorhoe defensaria,0,2,2,1.0,1.0
Xanthorhoe lacustrata,0,1,1,1.0,1.0
Xanthoria elegans,0,5,5,1.0,0.7760428250025136
Xanthoria parietina,1,1,2,0.2685730424867646,0.6723203844978234
Xanthotype barnesi,0,1,1,1.0,1.0
Xantusia vigilis,1,4,5,0.5424646889787644,1.0
Xenasmatella vaga,0,1,1,1.0,1.0
Xenolechia ceanothiella,0,4,4,1.0,0.9105509465652237
Xenox delila,0,3,3,1.0,1.0
Xerasia grisescens,0,1,1,1.0,1.0
Xeris indecisus,0,10,10,0.3757244358299004,0.39438447212016514
Xerocomellus atropurpureus,6,24,30,0.431253245476129,0.5482265886075415
Xerocomellus chrysenteron,1,0,1,0.14476460320460613,0.3126936942061339
Xerocomellus diffractus,3,2,5,0.02413002787627292,0.023975245305455268
Xerocomellus mendocinensis,0,1,1,1.0,1.0
Xerocomellus zelleri,1,0,1,0.14476460320460613,0.3126936942061339
Xerocomus subtomentosus,5,1,6,0.00033535930364562256,2.5155693289996723e-05
Xeromphalina campanella,8,18,26,0.04360585600613272,0.03729519913608298
Xeromphalina campanelloides,0,2,2,1.0,1.0
Xeromphalina cauticinalis,4,7,11,0.06219290144309395,0.10212099408086615
Xeromphalina cornui,0,1,1,1.0,1.0
Xeromphalina enigmatica,0,1,1,1.0,1.0
Xeromphalina fulvipes,1,0,1,0.14476460320460613,0.3126936942061339
Xerophyllum tenax,0,18,18,0.0958116006335464,0.1583481410858158
Xestia c-nigrum,0,4,4,1.0,0.9105509465652237
Xestia oblata,0,4,4,1.0,0.9105509465652237
Xestoleptura crassicornis,0,11,11,0.38449278358904854,0.3492157200022511
Xestoleptura crassipes,0,10,10,0.3757244358299004,0.39438447212016514
Xylaria hypoxylon,14,8,22,1.779054732155558e-07,4.091104295787523e-10
Xylocopa californica,24,51,75,0.00010350903220581405,3.3292052312679835e-05
Xylocopa sonorina,1,1,2,0.2685730424867646,0.6723203844978234
Xylocopa tabaniformis,13,24,37,0.0014196161063292974,0.0008437620755866887
Xylocrius cribratus,0,1,1,1.0,1.0
Xylotrechus albonotatus,0,16,16,0.15161267346782015,0.19687992504129675
Xylotrechus insignis,1,2,3,0.3744588472376553,0.9141432822130974
Xylotrechus nauticus,0,1,1,1.0,1.0
Xylotrechus undulatus,0,4,4,1.0,0.9105509465652237
Xystocheir brachymacris,0,4,4,1.0,0.9105509465652237
Xystocheir modestior,0,2,2,1.0,1.0
Xystocheir reducta,0,1,1,1.0,1.0
Yosemitea repanda,0,5,5,1.0,0.7760428250025136
Yphria californica,0,4,4,1.0,0.9105509465652237
Ypsolopha canariella,0,1,1,1.0,1.0
Yucca brevifolia,13,3,16,4.445709965410517e-09,4.624842109093228e-13
Zale lunata,1,1,2,0.2685730424867646,0.6723203844978234
Zale rubi,1,0,1,0.14476460320460613,0.3126936942061339
Zale termina,0,3,3,1.0,1.0
Zapus princeps,0,5,5,1.0,0.7760428250025136
Zarhipis integripennis,4,5,9,0.030121806187693938,0.03739180706614353
Zelleria haimbachi,1,5,6,1.0,1.0
Zeltnera exaltata,0,1,1,1.0,1.0
Zeltnera muhlenbergii,1,1,2,0.2685730424867646,0.6723203844978234
Zeltnera venusta,3,16,19,0.7489337316443154,1.0
Zelus renardii,6,2,8,0.00019772693610894856,1.2839299064071593e-05
Zelus tetracanthus,0,5,5,1.0,0.7760428250025136
Zenaida macroura,13,27,40,0.005065623031130544,0.002567597850316686
Zenophleps lignicolorata,3,1,4,0.010816792675262966,0.00633924523846032
Zenophleps obscurata,0,1,1,1.0,1.0
Zerene eurydice,1,0,1,0.14476460320460613,0.3126936942061339
Zonitoides arboreus,0,1,1,1.0,1.0
Zonotrichia atricapilla,16,10,26,4.573333604856251e-08,6.081241109342548e-11
Zonotrichia leucophrys,10,99,109,0.13358909584462322,0.15057180330655037
Zootermopsis nevadensis,6,36,42,1.0,1.0
Zopherus granicollis,2,25,27,0.41609323465062054,0.4410007741051609
Zotheca tranquilla,0,3,3,1.0,1.0
